Budget,Release Year,Revenue,Title,Starring Actors Popularity,profit
300000000,2007,961000000,Pirates of the Caribbean: At World's End,4383.529869,661000000
270000000,2006,391081192,Superman Returns,1555.519755,121081192
200000000,1997,1845034188,Titanic,324.6438211,1645034188
258000000,2007,890871626,Spider-Man 3,3171.497068,632871626
175000000,1995,264218220,Waterworld,3043.248683,89218220
250000000,2009,933959197,Harry Potter and the Half-Blood Prince,5985.424893,683959197
200000000,2003,435000000,Terminator 3: Rise of the Machines,5136.217883,235000000
237000000,2009,2787965087,Avatar,955.7387481,2550965087
207000000,2005,550000000,King Kong,693.250948,343000000
200000000,2004,783766341,Spider-Man 2,1903.862354,583766341
225000000,2008,419651413,The Chronicles of Narnia: Prince Caspian,1003.562491,194651413
210000000,2006,459359555,X-Men: The Last Stand,5197.240468,249359555
170000000,1999,222104681,Wild Wild West,3130.540091,52104681
160000000,1997,164508066,Speed 2: Cruise Control,1131.231418,4508066
200000000,2006,1065659812,Pirates of the Caribbean: Dead Man's Chest,3003.07531,865659812
160000000,1999,61698899,The 13th Warrior,782.5346567,-98301101
200000000,2008,586090727,Quantum of Solace,1499.301013,386090727
175000000,2004,497409852,Troy,3462.5235,322409852
180000000,2005,748806957,"The Chronicles of Narnia: The Lion, the Witch and the Wardrobe",0.0,568806957
200000000,2009,371353001,Terminator Salvation,2293.025284,171353001
200000000,2009,769653595,2012,1053.91274,569653595
200000000,2009,325233863,A Christmas Carol,4688.48896,125233863
140000000,1998,285444603,Lethal Weapon 4,2712.73246,145444603
140000000,1998,553799566,Armageddon,2428.312728,413799566
165000000,2004,305875730,The Polar Express,6847.670612,140875730
180000000,2007,372234864,The Golden Compass,1480.527214,192234864
185000000,2008,1004558444,The Dark Knight,1039.424306,819558444
185000000,2008,786636033,Indiana Jones and the Kingdom of the Crystal Skull,6757.288383,601636033
175000000,2007,173000000,Evan Almighty,2113.912775,-2000000
180000000,2008,521311860,WALLÂ·E,223.8488799,341311860
135000000,1999,361832400,The World Is Not Enough,2354.300944,226832400
155000000,2004,167298192,Alexander,2015.246687,12298192
115000000,1994,378882411,True Lies,3692.008265,263882411
150000000,2003,424988211,The Matrix Revolutions,1862.487031,274988211
150000000,2003,738599701,The Matrix Reloaded,1862.487031,588599701
150000000,2003,212011111,Master and Commander: The Far Side of the World,1370.958891,62011111
133000000,1999,300135367,Stuart Little,1949.84188,167135367
125000000,1997,238207122,Batman & Robin,4825.359416,113207122
140000000,2001,449220945,Pearl Harbor,1421.619609,309220945
175000000,2009,735099082,Up,381.0674566,560099082
175000000,2009,381509870,Monsters vs Aliens,1344.828223,206509870
175000000,2009,302469017,G.I. Joe: The Rise of Cobra,1595.951227,127469017
160000000,2006,181674817,Poseidon,1209.90887,21674817
150000000,2004,919838758,Shrek 2,4469.630794,769838758
137000000,2001,85131830,Final Fantasy: The Spirits Within,670.3597542,-51868170
140000000,2002,109578115,Treasure Planet,85.58041798,-30421885
140000000,2002,441818803,Men in Black II,3426.224691,301818803
140000000,2002,431971116,Die Another Day,3022.570878,291971116
139000000,2002,821708551,Spider-Man,1322.342907,682708551
100000000,1991,520000000,Terminator 2: Judgment Day,2528.280151,420000000
160000000,2007,798958165,Shrek the Third,5615.092412,638958165
150000000,2005,374218673,Batman Begins,2146.003548,224218673
150000000,2005,895921036,Harry Potter and the Goblet of Fire,3862.158561,745921036
150000000,2005,314432665,Chicken Little,1470.924094,164432665
150000000,2005,474968763,Charlie and the Chocolate Factory,2223.95669,324968763
145000000,2004,25819961,The Alamo,1175.94895,-119180039
140000000,2003,456758981,The Last Samurai,6214.740322,316758981
140000000,2003,655011224,Pirates of the Caribbean: The Curse of the Black Pearl,867.1581951,515011224
127500000,2000,354248063,Dinosaur,572.0436373,226748063
120000000,1998,363258859,A Bug's Life,267.8386221,243258859
116000000,1997,178127760,Dante's Peak,1533.618169,62127760
150000000,2006,397850012,Mission: Impossible III,7539.442377,247850012
150000000,2006,599045960,Casino Royale,295.7174859,449045960
137000000,2003,245360480,Hulk,494.4995162,108360480
125000000,2000,546388105,Mission: Impossible II,4856.612478,421388105
149000000,2006,64459316,Flushed Away,5197.240468,-84540684
123000000,2000,345141403,How the Grinch Stole Christmas,3210.630405,222141403
150000000,2007,585349010,I Am Legend,5951.460525,435349010
150000000,2007,623722818,Ratatouille,532.3927951,473722818
150000000,2007,938212738,Harry Potter and the Order of the Phoenix,4924.726433,788212738
150000000,2007,287594577,Bee Movie,2436.793552,137594577
150000000,2007,709709780,Transformers,23.43969559,559709780
125000000,2001,976475550,Harry Potter and the Philosopher's Stone,0.0,851475550
110000000,1997,333011068,Tomorrow Never Dies,1533.618169,223011068
120000000,2000,325756637,The Perfect Storm,759.6932112,205756637
130000000,2003,273339556,Bad Boys II,4024.524242,143339556
115000000,1999,924317558,Star Wars: Episode I - The Phantom Menace,660.1297795,809317558
150000000,2008,163712074,The Incredible Hulk,984.8319104,13712074
150000000,2008,309979994,Bolt,2577.579341,159979994
150000000,2008,624029371,Hancock,6584.095246,474029371
150000000,2008,333932083,The Curious Case of Benjamin Button,5556.699604,183932083
150000000,2008,603900354,Madagascar: Escape 2 Africa,4225.52758,453900354
120000000,2001,186053725,Atlantis: The Lost Empire,2340.729602,66053725
135000000,2005,76932943,Stealth,622.401877,-58067057
100000000,1995,336529144,Batman Forever,1495.262591,236529144
130000000,2004,789804554,Harry Potter and the Prisoner of Azkaban,2784.157212,659804554
150000000,2009,836297228,Transformers: Revenge of the Fallen,2513.644383,686297228
150000000,2009,385680446,Star Trek,821.2966598,235680446
150000000,2009,413106170,Night at the Museum: Battle of the Smithsonian,5143.849481,263106170
150000000,2009,373062864,X-Men Origins: Wolverine,2091.259966,223062864
150000000,2009,356613439,Angels & Demons,7888.843687,206613439
150000000,2009,292817841,G-Force,751.6317296,142817841
105000000,1997,121214377,Starship Troopers,0.0,16214377
145000000,2008,401128639,The Mummy: Tomb of the Dragon Emperor,941.2390791,256128639
132000000,2005,591739379,War of the Worlds,6885.697845,459739379
140000000,2007,258022233,Rush Hour 3,1305.942367,118022233
98000000,1995,10017322,Cutthroat Island,360.1023614,-87982678
120000000,2002,649398328,Star Wars: Episode II - Attack of the Clones,2060.049225,529398328
120000000,2002,169956806,Stuart Little 2,2573.283656,49956806
100000000,1996,242295562,Eraser,4244.5466,142295562
100000000,1996,100138851,The Hunchback of Notre Dame,1880.666568,138851
130000000,2005,211643158,Kingdom of Heaven,1666.986592,81643158
130000000,2005,119269486,Sahara,1296.477128,-10730514
115000000,2001,274703340,Lara Croft: Tomb Raider,1549.821591,159703340
115000000,2001,562816256,"Monsters, Inc.",1307.575711,447816256
125000000,2004,544272402,The Day After Tomorrow,677.4300066,419272402
140000000,2008,585174222,Iron Man,606.658837,445174222
110000000,2000,215294342,The Patriot,3340.606064,105294342
120000000,2003,259175788,Charlie's Angels: Full Throttle,3722.62668,139175788
126000000,2005,162949164,The Island,3059.408255,36949164
115000000,2002,77628265,Windtalkers,2581.210066,-37371735
120000000,2004,347234916,"I, Robot",4339.666084,227234916
130000000,2007,289047763,Fantastic 4: Rise of the Silver Surfer,371.1985955,159047763
55000000,1978,300218018,Superman,873.5594984,245218018
125000000,2006,767820459,The Da Vinci Code,7265.071495,642820459
85000000,1993,137298489,Last Action Hero,3495.563001,52298489
90000000,1995,366101666,Die Hard: With a Vengeance,1092.608337,276101666
107000000,2001,87713825,Ali,3361.742715,-19286175
92000000,1996,494471524,Twister,667.0591621,402471524
116000000,2004,102000000,The Aviator,4179.063867,-14000000
100000000,1999,211989043,End of Days,5015.469248,111989043
100000000,1999,93700000,Bicentennial Man,4149.024849,-6300000
103000000,2000,457640427,Gladiator,197.902127,354640427
130000000,2008,49554002,Australia,2073.583111,-80445998
130000000,2008,631744560,Kung Fu Panda,2365.338722,501744560
80000000,1992,280000000,Batman Returns,884.6683923,200000000
95000000,1998,250288523,The Mask of Zorro,1459.531891,155288523
110000000,2003,407711549,X2,3227.219396,297711549
120000000,2006,461983149,Cars,860.7739797,341983149
100000000,2000,155464351,What Lies Beneath,8214.26295,55464351
100000000,2000,169327687,The Emperor's New Groove,868.9577933,69327687
130000000,2009,185258983,Watchmen,1361.71587,55258983
102000000,2001,147080413,Swordfish,2193.658063,45080413
90000000,1997,263920180,The Fifth Element,1717.47504,173920180
90000000,1997,140807547,The Devil's Own,7678.076521,50807547
90000000,1997,171120329,Contact,517.6116034,81120329
90000000,1997,589390539,Men in Black,2049.274093,499390539
110000000,2004,362744280,Ocean's Twelve,3462.5235,252744280
110000000,2004,103951461,Home on the Range,89.14720477,-6048539
110000000,2004,72178895,Around the World in 80 Days,1291.19361,-37821105
54000000,1980,190458706,Superman II,912.7666211,136458706
113000000,2005,850000000,Star Wars: Episode III - Revenge of the Sith,3059.408255,737000000
100000000,2001,362211740,Planet of the Apes,886.3693462,262211740
100000000,2001,235926552,A.I. Artificial Intelligence,146.4018779,135926552
70000000,1989,90000098,The Abyss,617.88754,20000098
102000000,2002,358372926,Minority Report,5809.25407,256372926
90000000,1998,304320254,Mulan,2107.833018,214320254
90000000,1998,250649836,Enemy of the State,2756.919583,160649836
90000000,1998,69131860,Babe: Pig in the City,72.05994502,-20868140
90000000,1998,142940100,Meet Joe Black,2064.989208,52940100
98000000,2001,433013274,The Mummy Returns,239.6992108,335013274
95000000,2000,190213455,Hollow Man,1384.364596,95213455
95000000,2000,76432727,The Road to El Dorado,384.2025593,-18567273
110000000,2005,478207520,Mr. & Mrs. Smith,4620.910772,368207520
120000000,2008,93945766,Speed Racer,534.1342186,-26054234
100000000,2002,7103973,The Adventures of Pluto Nash,4094.325049,-92896027
100000000,2002,193772504,Gangs of New York,3518.826707,93772504
100000000,2002,35168966,K-19: The Widowmaker,7985.771195,-64831034
100000000,2002,876688482,Harry Potter and the Chamber of Secrets,1535.617471,776688482
70000000,1990,240031094,Die Hard 2,318.4597531,170031094
105000000,2004,115772733,The Chronicles of Riddick,1697.028557,10772733
58000000,1984,25928721,The Cotton Club,0.0,-32071279
31115000,1963,71000000,Cleopatra,190.9742745,39885000
85000000,1997,315156409,Air Force One,7678.076521,230156409
90000000,1999,497366869,Toy Story 2,4719.576802,407366869
90000000,1999,60289912,The Insider,1631.68771,-29710088
90000000,1999,161626121,Payback,3142.106432,71626121
110000000,2006,574480841,Night at the Museum,3619.024408,464480841
92000000,2000,264105545,Charlie's Angels,1979.642045,172105545
70000000,1991,300854823,Hook,1459.024594,230854823
94000000,2001,54744738,Driven,410.1194741,-39255262
93000000,2001,368780809,Jurassic Park III,2300.533542,275780809
93000000,2001,871368364,The Lord of the Rings: The Fellowship of the Ring,490.6421945,778368364
85000000,1998,71485043,What Dreams May Come,3763.785314,-13514957
80000000,1996,250200000,Space Jam,0.0,170200000
80000000,1996,309492681,Ransom,2006.919126,229492681
80000000,1996,457696359,Mission: Impossible,3672.131329,377696359
80000000,1996,159212469,Daylight,2515.696241,79212469
90000000,2000,60874615,Mission to Mars,1882.000823,-29125385
90000000,2000,237202299,Gone in Sixty Seconds,2201.77622,147202299
90000000,2000,429632142,Cast Away,5920.060344,339632142
90000000,2000,14828081,Supernova,182.2812646,-75171919
63000000,1988,189015611,Rambo III,1406.659183,126015611
110000000,2007,383531464,Live Free or Die Hard,5593.339187,273531464
110000000,2007,228738393,Ghost Rider,3275.961706,118738393
92000000,2001,172989651,Black Hawk Down,1538.255659,80989651
92000000,2001,143049560,Spy Game,2469.64467,51049560
100000000,2004,82102379,Catwoman,1492.770956,-17897621
100000000,2004,108103450,Hidalgo,3368.15251,8103450
100000000,2004,347451894,National Treasure,2632.081879,247451894
80000000,1997,245676146,Face/Off,1540.382463,165676146
80000000,1997,177977226,Flubber,3119.508053,97977226
80000000,1997,17626234,The Postman,3494.54785,-62373766
90000000,2001,10372291,Town & Country,732.918137,-79627709
90000000,2001,347325802,Rush Hour 2,679.7851266,257325802
65000000,1990,261317921,Total Recall,1553.854889,196317921
95000000,2003,156505388,Lara Croft Tomb Raider: The Cradle of Life,1121.469646,61505388
100000000,2005,202026112,Fun with Dick and Jane,4454.889045,102026112
70000000,1993,255000211,Cliffhanger,1780.496164,185000211
94000000,2003,940335536,Finding Nemo,48.27427294,846335536
94000000,2003,1118888979,The Lord of the Rings: The Return of the King,3227.219396,1024888979
85000000,2000,183611771,102 Dalmatians,1345.680984,98611771
80000000,1998,136159423,Lost in Space,1828.343489,56159423
65000000,1991,17218080,Hudson Hawk,834.3400364,-47781920
82000000,1999,47434430,Man on the Moon,3200.663791,-34565570
75000000,1996,335062621,The Rock,3259.209878,260062621
75000000,1996,816969268,Independence Day,1758.151426,741969268
84000000,2000,123307945,Nutty Professor II: The Klumps,3008.86414,39307945
100000000,2006,249288105,Eragon,842.8786331,149288105
100000000,2006,170877916,Blood Diamond,4132.625975,70877916
100000000,2006,384335608,Happy Feet,4480.140304,284335608
72000000,1995,210000000,Braveheart,986.0939917,138000000
83000000,2000,59468275,The Flintstones in Viva Rock Vegas,437.7636421,-23531725
85000000,2001,450717150,Ocean's Eleven,2469.64467,365717150
80000000,1999,91188905,The Haunting,660.1297795,11188905
80000000,1999,176885658,Analyze This,1386.922284,96885658
80000000,1999,90874570,Fantasia 2000,23.98827238,10874570
80000000,1999,118880016,Message in a Bottle,3367.95002,38880016
90000000,2003,182290266,The Haunted Mansion,4056.674213,92290266
82000000,2000,96085477,The 6th Day,5249.089097,14085477
75000000,1997,136982834,Conspiracy Theory,2526.470515,61982834
75000000,1997,224012234,Con Air,783.1530767,149012234
92000000,2004,631442092,The Incredibles,2774.883785,539442092
100000000,2007,266465037,American Gangster,2779.256204,166465037
55000000,1987,14375181,Ishtar,567.1951807,-40624819
46000000,1981,5200000,Inchon,10.51695602,-40800000
60000000,1990,157920733,Days of Thunder,2238.816181,97920733
105000000,2009,267045765,The Princess and the Frog,43.18901132,162045765
85000000,2002,78382433,Collateral Damage,5146.996552,-6617567
80000000,2000,33463969,Red Planet,2164.047349,-46536031
80000000,2000,34566746,Thirteen Days,3487.0712,-45433254
80000000,2000,39459427,The Legend of Bagger Vance,1577.258477,-40540573
90000000,2004,102000000,The Stepford Wives,1603.681093,12000000
73000000,1997,229074524,The Lost World: Jurassic Park,3210.151373,156074524
87000000,2003,148336445,Seabiscuit,398.1002702,61336445
75000000,1998,46683377,Practical Magic,1398.671407,-28316623
75000000,1998,14567883,Soldier,759.0161039,-60432117
75000000,1998,140464664,Deep Impact,572.0288924,65464664
75000000,1998,13100000,Sphere,2254.574675,-61900000
44000000,1980,3484331,Heaven's Gate,34.73193851,-40515669
84000000,2002,275650703,Scooby-Doo,332.6452427,191650703
70000000,1996,101371017,Mars Attacks!,1586.025968,31371017
85000000,2003,80916492,The Rundown,299.75863,-4083508
63000000,1993,920100000,Jurassic Park,29.46128196,857100000
73000000,1998,103891409,Snake Eyes,1783.662835,30891409
75000000,1999,19598588,The Astronaut's Wife,291.1904523,-55401412
75000000,1999,108000000,Three Kings,591.800088,33000000
75000000,1999,29000000,The Out-of-Towners,471.8834795,-46000000
97250400,2008,132900000,Asterix at the Olympic Games,0.0,35649600
100000000,2009,100086793,Where the Wild Things Are,415.7695287,86793
100000000,2009,150166126,The Taking of Pelham 1 2 3,3025.960182,50166126
100000000,2009,242988466,Cloudy with a Chance of Meatballs,864.9059284,142988466
100000000,2009,68688831,Land of the Lost,1205.486897,-31311169
70000000,1997,162000000,Alien: Resurrection,865.0471092,92000000
70000000,1997,131457682,Seven Years in Tibet,1616.957,61457682
55000000,1989,63408614,Tango & Cash,1811.075039,8408614
76000000,2000,35134820,The Adventures of Rocky & Bullwinkle,733.2922692,-40865180
88000000,2005,108539911,Cinderella Man,2342.488992,20539911
88000000,2005,105316267,The Brothers Grimm,3148.5481,17316267
80000000,2002,123729176,The Time Machine,513.4957196,43729176
80000000,2002,145771527,Lilo & Stitch,0.0,65771527
80000000,2002,181001478,Road to Perdition,6340.246738,101001478
80000000,2002,122563539,Spirit: Stallion of the Cimarron,2341.091186,42563539
90000000,2006,65900249,Flags of Our Fathers,375.901462,-24099751
90000000,2006,289847354,The Departed,4132.625975,199847354
71000000,1998,294456605,Doctor Dolittle,2107.833018,223456605
63000000,1994,25052000,Wyatt Earp,3060.256983,-37948000
73000000,1999,151493655,The Bone Collector,1618.05838,78493655
75000000,2000,296339527,X-Men,1264.33638,221339527
75000000,2000,248118121,Unbreakable,4670.531146,173118121
75000000,2000,215663859,Vertical Limit,1458.87903,140663859
75000000,2000,36754634,Titan A.E.,2083.122965,-38245366
79000000,2002,926287400,The Lord of the Rings: The Two Towers,1850.944469,847287400
68000000,1997,118063304,The Saint,1713.071682,50063304
70000000,1998,118000000,Star Trek: Insurrection,728.2244799,48000000
70000000,1998,481840909,Saving Private Ryan,3538.986625,411840909
70000000,1998,19870567,Hard Rain,2619.607106,-50129433
70000000,1998,218613188,The Prince of Egypt,1882.885222,148613188
70000000,1998,56702901,A Civil Action,1957.570498,-13297099
70000000,1998,116672912,The Siege,2428.312728,46672912
70000000,1998,164000000,Six Days Seven Nights,8272.303824,94000000
62000000,1994,215887717,Clear and Present Danger,7890.475099,153887717
78000000,2002,209196298,Red Dragon,1998.749362,131196298
85000000,2005,162242962,Memoirs of a Geisha,858.1349913,77242962
80000000,2003,68514844,Looney Tunes: Back in Action,947.4313312,-11485156
80000000,2003,484572835,Bruce Almighty,3823.913865,404572835
80000000,2003,116643346,S.W.A.T.,2596.816975,36643346
80000000,2003,19480739,Timeline,503.8754339,-60519261
80000000,2003,266728738,Something's Gotta Give,2180.175344,186728738
65000000,1996,89456761,The Long Kiss Goodnight,1092.777519,24456761
75000000,2001,67631903,Bandits,5255.602891,-7368097
75000000,2001,13596911,Osmosis Jones,929.8601246,-61403089
75000000,2001,54249294,Domestic Disturbance,2193.658063,-20750706
75000000,2001,5409517,Monkeybone,239.6992108,-69590483
92000000,2008,188072649,Tropic Thunder,4225.52758,96072649
54000000,1990,136766062,The Godfather: Part III,1111.755372,82766062
79000000,2003,173013509,Cold Mountain,1572.270075,94013509
70000000,1999,177841558,Double Jeopardy,2980.385633,107841558
70000000,1999,11263966,Chill Factor,705.3682937,-58736034
70000000,1999,23159305,The Iron Giant,828.0127315,-46840695
70000000,1999,309457509,Runaway Bride,2627.735292,239457509
86000000,2006,107944236,Arthur and the Invisibles,663.6480471,21944236
62000000,1995,107879496,The American President,1942.402079,45879496
60000000,1994,223664608,Interview with the Vampire,3399.440212,163664608
78000000,2003,179265204,The League of Extraordinary Gentlemen,3492.613265,101265204
85000000,2006,194168700,The Holiday,5143.30903,109168700
85000000,2006,158468292,The Fast and the Furious: Tokyo Drift,0.0,73468292
85000000,2006,197309027,Open Season,1775.42323,112309027
85000000,2006,144000000,Charlotte's Web,3986.956613,59000000
35000000,1976,35323292,The Bad News Bears,0.0,323292
80000000,2004,55041367,Spanglish,1018.180926,-24958633
80000000,2004,78000586,Exorcist: The Beginning,617.7745533,-1999414
80000000,2004,96105964,The Manchurian Candidate,2385.464546,16105964
80000000,2004,516642939,Meet the Fockers,2375.196281,436642939
90000000,2008,162839667,The Spiderwick Chronicles,867.0888609,72839667
90000000,2008,201596308,You Don't Mess with the Zohan,1845.075183,111596308
82000000,2005,190320568,The Longest Yard,1332.803704,108320568
75000000,2002,114660784,We Were Soldiers,4479.273066,39660784
68000000,1999,29762011,Mystery Men,736.7903773,-38237989
66000000,1998,189198313,The X Files,0.0,123198313
70000000,2000,374111707,What Women Want,3340.606064,304111707
86000000,2007,14373825,Awake,2078.086041,-71626175
72000000,2001,37317558,The Majestic,3940.687678,-34682442
72000000,2001,27642707,The Last Castle,943.0949458,-44357293
55000000,1992,149022650,Death Becomes Her,853.4316033,94022650
60000000,1995,35431113,Money Train,32.29361868,-24568887
60000000,1995,104324083,Under Siege 2: Dark Territory,115.3155439,44324083
76000000,2003,236350661,2 Fast 2 Furious,437.3632314,160350661
85000000,2007,340487652,Enchanted,253.2634662,255487652
85000000,2007,311312624,Ocean's Thirteen,5249.473875,226312624
85000000,2007,149044513,Surf's Up,528.4371779,64044513
82500000,2006,237681299,Click,1569.423988,155181299
80000000,2005,5989640,A Sound of Thunder,355.6620216,-74010360
80000000,2005,162944923,The Interpreter,1314.935601,82944923
80000000,2005,10166502,The Great Raid,1160.821779,-69833498
90000000,2009,524028679,Sherlock Holmes,1313.08743,434028679
90000000,2009,886686817,Ice Age: Dawn of the Dinosaurs,2237.630529,796686817
65000000,1998,250821495,You've Got Mail,3538.986625,185821495
65000000,1998,40002112,I Still Know What You Did Last Summer,222.286077,-24997888
75000000,2003,51142659,Hollywood Homicide,7796.742136,-23857341
44000000,1985,300400432,Rambo: First Blood Part II,729.4129891,256400432
66000000,1999,212404396,Entrapment,3519.542551,146404396
70000000,2001,176104344,Dr. Dolittle 2,3134.133338,106104344
72000000,2002,408247917,Signs,4479.273066,336247917
60000000,1996,129832389,Jingle All the Way,4244.5466,69832389
58000000,1995,352194034,GoldenEye,924.3418408,294194034
50000000,1990,41482207,Gremlins 2: The New Batch,357.3043811,-8517793
40600000,1983,90400000,Trading Places,413.1787696,49800000
85000000,2008,160388063,Hellboy II: The Golden Army,479.1915666,75388063
85000000,2008,222231186,Jumper,3795.230674,137231186
80000000,2006,660940780,Ice Age: The Meltdown,1254.28025,580940780
80000000,2006,343397247,Over the Hedge,5086.848041,263397247
65000000,1999,36850101,My Favorite Martian,536.1338195,-28149899
65000000,1999,162091208,Eyes Wide Shut,4697.753973,97091208
65000000,1999,117758500,Blue Streak,249.2744423,52758500
75000000,2004,196482882,50 First Dates,2367.740138,121482882
75000000,2004,367275019,Shark Tale,4339.666084,292275019
75000000,2004,288500217,The Bourne Supremacy,2794.79659,213500217
48000000,1989,474171806,Indiana Jones and the Last Crusade,6622.111571,426171806
74500000,2004,62172050,Two Brothers,554.2707946,-12327950
68000000,2001,71069884,The Score,2223.335365,3069884
68000000,2001,96976270,Enemy at the Gates,838.26372,28976270
68000000,2001,203388341,Vanilla Sky,5624.555913,135388341
70000000,2002,32287044,Hart's War,5245.91234,-37712956
70000000,2002,19924033,Ballistic: Ecks vs. Sever,1134.109643,-50075967
70000000,2002,277448382,xXx,2074.925692,207448382
70000000,2002,33561137,I Spy,4094.325049,-36438863
70000000,2002,65977295,Bad Company,1998.749362,-4022705
64000000,1999,74608570,Random Hearts,8324.832996,10608570
49000000,1990,20423389,The Adventures of Ford Fairlane,0.0,-28576611
55000000,1994,214015089,Disclosure,1520.930152,159015089
55000000,1994,677945399,Forrest Gump,1090.40604,622945399
60000000,1997,26673242,Event Horizon,1966.049135,-33326758
60000000,1997,159330280,The Jackal,1717.47504,99330280
60000000,1997,33956608,The Relic,474.9674032,-26043392
85000000,2009,219103655,It's Complicated,2278.959221,134103655
35000000,1979,31755742,1941,437.6197884,-3244258
35000000,1979,139000000,Star Trek: The Motion Picture,53.23645677,104000000
80000000,2007,15071514,The Invasion,1480.527214,-64928486
65000000,2000,128884132,Space Cowboys,3210.397048,63884132
65000000,2000,69700000,The Kid,4670.531146,4700000
63000000,1999,463517383,The Matrix,1067.049569,400517383
63000000,1999,100853753,Fight Club,2266.913531,37853753
75000000,2005,142400065,The Legend of Zorro,2331.698426,67400065
75000000,2005,260696994,Robots,3963.424818,185696994
75000000,2005,532680671,Madagascar,2938.001159,457680671
39000000,1983,75850624,Superman III,1390.167373,36850624
40000000,1984,30925690,Dune,44.22700825,-9074310
57000000,1996,115267375,DragonHeart,90.92921096,58267375
68000000,2002,193000000,The Sum of All Fears,2584.20325,125000000
70000000,2003,85632458,Tears of the Sun,5176.988557,15632458
70000000,2003,122919055,Big Fish,3008.16684,52919055
55000000,1995,346079773,Pocahontas,986.0939917,291079773
55000000,1995,127600435,First Knight,3123.242114,72600435
60000000,1998,186883563,The Horse Whisperer,1970.507211,126883563
60000000,1998,264118201,The Truman Show,2774.695702,204118201
60000000,1998,171757863,Antz,753.2061156,111757863
76000000,2006,69959751,Children of Men,1077.073386,-6040249
63600000,2000,19412993,Get Carter,2615.760002,-44187007
80341000,2008,127814609,Red Cliff,269.2463012,47473609
50000000,1992,159773545,AlienÂ³,642.0646625,109773545
34000000,1979,210308099,Moonraker,1416.41342,176308099
35000000,1980,27107960,Flash Gordon,1443.776921,-7892040
47000000,1990,103738726,Dick Tracy,1111.755372,56738726
80000000,2008,233093859,The Day the Earth Stood Still,3759.225929,153093859
80000000,2008,163733697,Four Christmases,1619.457372,83733697
80000000,2008,212874442,Bedtime Stories,1845.075183,132874442
80000000,2008,178066569,Eagle Eye,1306.787757,98066569
80000000,2008,230685453,Get Smart,964.4432223,150685453
65000000,2001,117487473,A Knight's Tale,436.1330465,52487473
75000000,2006,140175006,Monster House,62.91868209,65175006
75000000,2006,42285169,Lady in the Water,634.9809745,-32714831
48000000,1991,390493908,Robin Hood: Prince of Thieves,1093.762779,342493908
57000000,1997,152944660,The Devil's Advocate,1377.220521,95944660
68000000,2003,75715436,Dreamcatcher,2913.971146,7715436
70000000,2004,57958696,Sky Captain and the World of Tomorrow,1460.351506,-12041304
70000000,2004,171183863,AVP: Alien vs. Predator,165.352109,101183863
70000000,2004,130293714,Man on Fire,2385.464546,60293714
70000000,2004,154648887,The Phantom of the Opera,311.0518778,84648887
72000000,2005,96889998,Jarhead,824.5191246,24889998
62000000,2000,127666415,U-571,1458.87903,65666415
55000000,1996,121969216,Executive Decision,396.4417057,66969216
55000000,1996,18626419,The Fan,950.4157943,-36373581
55000000,1996,141047179,Evita,409.7768943,86047179
25485000,1970,29548291,Tora! Tora! Tora!,123.7122197,4063291
60000000,1999,73648228,Deep Blue Sea,0.0,13648228
60000000,1999,66976317,The Messenger: The Story of Joan of Arc,2220.304843,6976317
60000000,1999,284600000,The Green Mile,4719.576802,224600000
60000000,1999,149705852,The General's Daughter,2009.441225,89705852
53000000,1995,157387195,Crimson Tide,1418.930632,104387195
80000000,2009,214104620,Public Enemies,5434.037669,134104620
80000000,2009,122444772,Surrogates,5821.307298,42444772
80000000,2009,53825515,Nine,512.3828235,-26174485
65000000,2002,172855065,The Santa Clause 2,1871.318831,107855065
75000000,2007,527068851,The Simpsons Movie,0.0,452068851
75000000,2007,119000410,Charlie Wilson's War,8131.930407,44000410
54000000,1996,128769345,The Nutty Professor,1975.213475,74769345
72500000,2006,162966177,Talladega Nights: The Ballad of Ricky Bobby,714.4727469,90466177
25000000,1970,3052000,Waterloo,1198.034987,-21948000
70000000,2005,368100420,Hitch,5269.653613,298100420
70000000,2005,130358911,Munich,1072.138426,60358911
52000000,1995,355237933,Apollo 13,2377.875526,303237933
52000000,1995,116112375,Casino,2560.566784,64112375
62000000,2001,18720175,3000 Miles to Graceland,3459.798004,-43279825
55000000,1997,11466088,Turbulence,458.7381821,-43533912
60000000,2000,47383689,Almost Famous,1.308687299,-12616311
78146652,2009,60000000,Duplicity,4096.656727,-18146652
50000000,1994,16671505,Baby's Day Out,0.0,-33328495
50000000,1994,119208989,Beverly Hills Cop III,1798.594012,69208989
50000000,1994,49000000,On Deadly Ground,177.8244928,-1000000
35000000,1982,69701637,The Best Little Whorehouse in Texas,89.96096194,34701637
36000000,1983,160000000,Never Say Never Again,2008.738027,124000000
63000000,2002,296655431,Austin Powers in Goldmember,1573.247368,233655431
75000000,2008,258270008,Wanted,3462.489382,183270008
75000000,2008,200276000,Valkyrie,7771.52019,125276000
48000000,1993,20915465,Super Mario Bros.,17.25617936,-27084535
40000000,1987,191185897,The Living Daylights,0.0,151185897
66000000,2004,99318987,Hellboy,318.3272139,33318987
70000000,2006,38629478,Basic Instinct 2,986.5534604,-31370522
70000000,2006,154937680,Dreamgirls,5543.422892,84937680
31500000,1979,89460381,Apocalypse Now,1784.445588,57960381
55000000,1998,198685114,City of Angels,1598.052396,143685114
55000000,1998,41610884,Ronin,1347.456142,-13389116
60000000,2001,93375151,Cats & Dogs,3319.572531,33375151
60000000,2001,484409218,Shrek,3134.133338,424409218
60000000,2001,313542341,A Beautiful Mind,926.1735261,253542341
60000000,2001,56359980,15 Minutes,2223.335365,-3640020
60000000,2001,105178561,Along Came a Spider,2477.711179,45178561
50000000,1995,287928194,Casper,77.72183203,237928194
50000000,1995,10382407,The Scarlet Letter,1902.239061,-39617593
50000000,1995,189859560,Outbreak,1920.630837,139859560
50000000,1995,9851610,Jade,0.0,-40148390
50000000,1995,152022101,Congo,181.8067894,102022101
50000000,1995,30303072,Assassins,2519.798762,-19696928
53000000,1997,139804348,Anastasia,2221.249297,86804348
65000000,2004,128905366,Blade: Trinity,702.6652827,63905366
65000000,2004,217764291,Collateral,6738.964395,152764291
75000000,2009,61458982,Funny People,2333.140931,-13541018
75000000,2009,443140005,Alvin and the Chipmunks: The Squeakquel,609.6366913,368140005
45000000,1992,178051587,Patriot Games,7161.434027,133051587
70000000,2007,135560026,Stardust,1141.115322,65560026
70000000,2007,195735876,Beowulf,2145.275901,125735876
70000000,2007,442824138,The Bourne Ultimatum,3674.70897,372824138
70000000,2007,53587404,Dragon Wars: D-War,253.2723203,-16412596
70000000,2007,86658558,The Kingdom,1044.75035,16658558
55000000,1999,100230832,Any Given Sunday,1812.633643,45230832
60000000,2002,165333180,The Scorpion King,455.4417023,105333180
60000000,2002,93354918,Two Weeks Notice,1698.852383,33354918
60000000,2002,43061982,Reign of Fire,1043.914953,-16938018
60000000,2002,214034224,The Bourne Identity,2341.091186,154034224
60000000,2002,52322400,Dragonfly,3404.83082,-7677600
60000000,2002,55003135,Analyze That,2371.674478,-4996865
60000000,2002,67312826,Star Trek: Nemesis,1680.40694,7312826
20000000,1965,15473333,The Greatest Story Ever Told,0.0,-4526667
50000000,1996,75000000,The Ghost and the Darkness,1520.384512,25000000
50000000,1996,273552592,Jerry Maguire,3672.131329,223552592
50000000,1996,150270147,Broken Arrow,1014.317692,100270147
50000000,1996,113309743,Striptease,1880.666568,63309743
50000000,1996,42277365,Escape from L.A.,396.4417057,-7722635
50000000,1996,60209334,Chain Reaction,2376.200591,10209334
32000000,1981,40382659,Reds,317.1127344,8382659
65000000,2005,64321501,Zathura: A Space Adventure,100.2105314,-678499
37000000,1986,37962774,Howard the Duck,1059.477235,962774
59000000,2002,383257136,Ice Age,700.6178496,324257136
40000000,1989,332000000,Back to the Future Part II,1083.70203,292000000
45000000,1993,195268056,The Pelican Brief,1718.007752,150268056
57000000,2001,16991902,Rock Star,886.3693462,-40008098
57000000,2001,62112895,Captain Corelli's Mandolin,2538.68302,5112895
57000000,2001,147845033,The Mexican,4022.445027,90845033
70000000,2008,111231041,Fool's Gold,1543.897256,41231041
70000000,2008,113280098,Body of Lies,4548.639108,43280098
70000000,2008,225990978,Yes Man,4512.475253,155990978
70000000,2008,72108608,Babylon A.D.,1860.257602,2108608
52000000,1998,98126565,The Thin Red Line,316.4181956,46126565
19000000,1964,4750000,The Fall of the Roman Empire,510.2215991,-14250000
55000000,2000,56932305,Shanghai Noon,600.161823,1932305
55000000,2000,330444045,Meet the Parents,1648.536761,275444045
46000000,1994,341631208,The Flintstones,314.527313,295631208
60000000,2003,26288320,Sinbad: Legend of the Seven Seas,3502.274821,-33711680
60000000,2003,119940815,Intolerable Cruelty,2023.902905,59940815
60000000,2003,176070171,The Italian Job,1433.686784,116070171
60000000,2003,74208267,The Core,495.1428968,14208267
60000000,2003,96269812,Paycheck,2544.611194,36269812
60000000,2003,164433867,Daddy Day Care,4056.674213,104433867
50000000,1997,314178011,As Good as It Gets,1731.654714,264178011
50000000,1997,48169156,G.I. Jane,2228.336025,-1830844
50000000,1997,109423648,The Game,1527.211336,59423648
50000000,1997,50068310,Absolute Power,1917.033886,68310
50000000,1997,10541523,Mad City,2176.262445,-39458477
67000000,2007,25037897,Grindhouse,1113.78237,-41962103
67000000,2007,25303038,The Last Legion,847.2561182,-41696962
65000000,2006,43545364,We Are Marshall,1433.731563,-21454636
65000000,2006,422610419,300,516.2451245,357610419
44000000,1993,368875760,The Fugitive,7344.929054,324875760
40000000,1990,244527583,Back to the Future Part III,1634.650885,204527583
45000000,1994,117615211,The Client,1295.648873,72615211
45000000,1994,170362582,The Specialist,2244.578532,125362582
45000000,1994,788241776,The Lion King,263.7132797,743241776
70000000,2009,171844840,Couples Retreat,1793.705815,101844840
70000000,2009,319131050,Inglourious Basterds,6062.112498,249131050
70000000,2009,104945765,Planet 51,1018.522013,34945765
70000000,2009,39041505,Agora,932.4444758,-30958495
64000000,2006,101595121,Little Man,363.3844072,37595121
62000000,2005,52304001,Ãon Flux,964.190716,-9695999
32350000,1983,572700000,Return of the Jedi,4933.566168,540350000
60000000,2004,219417255,The Terminal,6847.670612,159417255
60000000,2004,13395939,Alfie,675.3148957,-46604061
60000000,2004,74541707,Ladder 49,2400.693104,14541707
60000000,2004,61347797,After the Sunset,3531.254639,1347797
60000000,2004,256697520,The Village,1498.709998,196697520
60000000,2004,170268750,Starsky & Hutch,1493.6708,110268750
50000000,1998,44547681,The Negotiator,1549.739288,-5452319
50000000,1998,202292902,Patch Adams,3763.785314,152292902
47000000,1996,12379402,Mary Reilly,1982.299333,-34620598
47000000,1996,102825796,The Cable Guy,2368.50406,55825796
65000000,2007,84785914,Zodiac,1167.102158,19785914
63000000,2006,162945894,World Trade Center,3051.897353,99945894
40000000,1991,205405498,JFK,1093.762779,165405498
45000000,1995,20350754,Showgirls,132.2650492,-24649246
52000000,2000,256271286,Erin Brockovich,3690.701496,204271286
55000000,2002,6416302,D-Tox,2507.139034,-48583698
55000000,2002,154906693,Maid in Manhattan,1285.44057,99906693
46000000,1996,100860818,Courage Under Fire,1285.898098,54860818
46000000,1996,150000000,Star Trek: First Contact,227.3571661,104000000
60000000,2005,71073932,xXx: State of the Union,3620.5376,11073932
60000000,2005,55987321,Doom,632.6171082,-4012679
60000000,2005,129181830,Cheaper by the Dozen 2,771.9186163,69181830
42000000,1993,270248367,The Firm,2925.617663,228248367
50000000,1999,73956241,The Hurricane,1618.05838,23956241
50000000,1999,58900031,The Story of Us,3526.877004,8900031
53000000,2001,29700000,Angel Eyes,683.7510517,-23300000
53000000,2001,83282296,Blow,652.5421291,30282296
65000000,2008,128107642,Step Brothers,1064.835632,63107642
56000000,2003,12923936,Gods and Generals,957.7761081,-43076064
44000000,1995,13681765,Nixon,1394.205785,-30318235
51000000,2000,149270999,"Me, Myself & Irene",3210.630405,98270999
52500000,2001,179213434,Moulin Rouge!,1538.255659,126713434
48000000,1998,77745568,Out of Sight,467.7651559,29745568
54000000,2002,155010032,Blade II,493.0637771,101010032
17000000,1963,10000000,55 Days at Peking,191.7859152,-7000000
40000000,1992,75505856,The Last of the Mohicans,5.429120879,35505856
40000000,1992,70100000,Boomerang,1738.239269,30100000
40000000,1992,243240178,A Few Good Men,2480.8763,203240178
40000000,1992,107458785,A League of Their Own,484.3832601,67458785
40000000,1992,14358033,Memoirs of an Invisible Man,233.1410886,-25641967
40000000,1992,215862692,Dracula,654.6342935,175862692
45000000,1996,53854588,Tin Cup,3472.942138,8854588
45000000,1996,17300889,The Phantom,0.0,-27699111
57000000,2004,28283637,Thunderbirds,0.0,-28716363
55000000,2003,34234008,The Hunted,3866.958043,-20765992
55000000,2003,231449203,American Wedding,873.6637812,176449203
55000000,2003,33828318,Stuck on You,2805.075562,-21171682
60000000,2006,17800000,Flyboys,1151.308108,-42200000
60000000,2006,77920346,The Sentinel,1819.273892,17920346
58000000,2005,102854431,Just Like Heaven,792.1299989,44854431
20000000,1969,31678778,Paint Your Wagon,116.3453159,11678778
65000000,2009,93525586,The Lovely Bones,2047.264581,28525586
65000000,2009,44091067,Astro Boy,3469.649525,-20908933
56000000,2004,57223890,Walking Tall,367.2259443,1223890
61000000,2007,95696996,Shooter,1682.752814,34696996
38000000,1991,34416893,The Doors,802.894655,-3583107
44000000,1996,165615285,Sleepers,1342.73804,121615285
48000000,1999,124305181,The Thomas Crown Affair,2354.300944,76305181
54000000,2003,7266209,Gigli,2544.611194,-46733791
17000000,1964,72070731,My Fair Lady,343.3164068,55070731
45000000,1997,136885767,Anaconda,915.8488236,91885767
45000000,1997,181000000,Liar Liar,2507.059011,136000000
45000000,1997,2154540,Shadow Conspiracy,1140.677519,-42845460
57000000,2005,52034889,Elizabethtown,3154.029588,-4965111
28000000,1981,195312802,For Your Eyes Only,1975.332629,167312802
52000000,2002,352114312,Catch Me If You Can,6340.246738,300114312
62000000,2008,41819064,The Love Guru,4072.923767,-20180936
60000000,2007,361366633,Alvin and the Chipmunks,150.0829318,301366633
60000000,2007,137587063,Bridge to Terabithia,792.6394099,77587063
27000000,1980,115229890,The Blues Brothers,524.3779626,88229890
50000000,2001,79958599,Exit Wounds,463.2839823,29958599
50000000,2001,100020092,Don't Say a Word,1904.595022,50020092
35000000,1989,411348924,Batman,432.4770924,376348924
56000000,2005,113006880,The Pacifier,1826.60862,57006880
31000000,1985,128499205,Out of Africa,732.8589795,97499205
48000000,2000,90383208,Bedazzled,176.3902578,42383208
48000000,2000,207515725,Traffic,1607.557892,159515725
40000000,1994,24332324,Renaissance Man,1245.851235,-15667676
45000000,1998,131183530,Blade,127.2216077,86183530
45000000,1998,11203026,Deep Rising,30.8973599,-33796974
28000000,1982,33139618,Blade Runner,4947.973552,5139618
49000000,2001,72700000,The One,147.4604954,23700000
55000000,2005,223387299,Flightplan,970.7347026,168387299
60000000,2008,50650079,Meet Dave,6524.550253,-9349921
60000000,2008,39031337,The Spirit,3795.230674,-20968663
60000000,2008,57490374,Inkheart,941.2390791,-2509626
60000000,2008,50877145,The Tale of Despereaux,6052.98766,-9122855
60000000,2008,163403799,The Happening,2075.518776,103403799
60000000,2008,244082376,Marley & Me,1610.36916,184082376
60000000,2008,73174566,Righteous Kill,3701.155796,13174566
50000000,2002,56714147,Murder by Numbers,1694.239561,6714147
50000000,2002,26199517,Blood Work,1145.393391,-23800483
50000000,2002,119137784,Unfaithful,1790.119519,69137784
50000000,2002,171269535,Mr. Deeds,892.5610255,121269535
35000000,1990,57120318,Predator 2,339.0426267,22120318
30000000,1985,152427960,A View to a Kill,2812.395458,122427960
48000000,2001,50315140,K-PAX,1596.168715,2315140
48000000,2001,85498534,Rat Race,1404.901236,37498534
48000000,2001,35743308,Riding in Cars with Boys,2026.053832,-12256692
45000000,1999,90683916,Galaxy Quest,1115.251305,45683916
45000000,1999,10667893,Universal Soldier: The Return,523.7905065,-34332107
15000000,1962,69995385,Lawrence of Arabia,176.571345,54995385
55000000,2006,9450897,All the King's Men,3270.999531,-45549103
55000000,2006,65664721,16 Blocks,5086.848041,10664721
55000000,2006,307077295,The Pursuit of Happyness,5664.685931,252077295
46000000,2000,107196498,Shaft,1580.980413,61196498
24000000,1978,21049053,The Wiz,0.0,-2950947
60000000,2009,62357900,Year One,2265.057603,2357900
60000000,2009,122233971,Invictus,4480.408524,62233971
60000000,2009,87784194,State of Play,2401.148336,27784194
60000000,2009,124596398,Coraline,1157.988925,64596398
60000000,2009,31720158,The Soloist,1313.08743,-28279842
58000000,2008,41299492,Leatherheads,3125.696297,-16700508
50000000,2003,177371441,How to Lose a Guy in 10 Days,1086.975584,127371441
50000000,2003,88323487,Shanghai Knights,1185.892596,38323487
50000000,2003,42792561,Basic,2596.816975,-7207439
50000000,2003,55495563,Out of Time,2357.806136,5495563
50000000,2003,38955598,The Life of David Gale,3165.647524,-11044402
53000000,2005,95226116,Be Cool,2525.574233,42226116
35000000,1991,182300000,Cape Fear,431.3048796,147300000
27500000,1983,187500000,Octopussy,2431.027998,160000000
38000000,1994,120000000,Star Trek: Generations,0.0,82000000
48000000,2002,196397415,Panic Room,736.9482168,148397415
54000000,2006,130431368,"You, Me and Dupree",956.2831937,76431368
54000000,2006,132511035,V for Vendetta,3748.773044,78511035
40000000,1996,49627779,The Island of Dr. Moreau,1520.384512,9627779
40000000,1996,152266007,A Time to Kill,1092.777519,112266007
45000000,2000,212000000,Miss Congeniality,1417.896854,167000000
45000000,2000,224834564,Chicken Run,3340.606064,179834564
45000000,2000,113916474,Coyote Ugly,868.9577933,68916474
28000000,1984,333000000,Indiana Jones and the Temple of Doom,6359.179376,305000000
52000000,2005,77944725,Hostage,5100.524805,25944725
55000000,2007,70016220,3:10 to Yuma,1754.897666,15016220
55000000,2007,74237563,Elizabeth: The Golden Age,1920.382116,19237563
27000000,1983,16519460,Krull,0.0,-10480540
27000000,1983,21500000,The Right Stuff,0.0,-5500000
58000000,2009,85280250,Did You Hear About the Morgans?,1986.474187,27280250
50000000,2004,49718611,Raising Helen,1430.813741,-281389
50000000,2004,40203020,Bridget Jones: The Edge of Reason,1956.793527,-9796980
50000000,2004,200804534,Garfield,471.2186678,150804534
50000000,2004,170128460,Shall We Dance?,1964.551176,120128460
50000000,2004,6808550,The Big Bounce,2955.917212,-43191450
50000000,2004,34808403,The Life Aquatic with Steve Zissou,1573.902617,-15191597
35000000,1992,4651977,Radio Flyer,0.0,-30348023
35000000,1992,321731527,Lethal Weapon 3,1168.557693,286731527
32000000,1989,156167015,Licence to Kill,445.4960187,124167015
44000000,2000,21400000,Battlefield Earth,2211.64998,-22600000
48000000,2003,220673217,Scary Movie 3,0.0,172673217
40000000,1997,87840042,Spawn,307.6541911,47840042
40000000,1997,45916769,The Rainmaker,1202.559372,5916769
18000000,1970,24911670,Catch-22,4.359786297,6911670
45000000,2001,141220678,Scary Movie 2,6.892181759,96220678
45000000,2001,104876233,Training Day,2136.240206,59876233
52000000,2006,204999686,The Break-Up,1405.918239,152999686
22000000,1977,12000000,Sorcerer,1704.716089,-10000000
22000000,1977,50750000,A Bridge Too Far,834.0679087,28750000
55000000,2008,17869048,City of Ember,117.5907466,-37130952
55000000,2008,113020255,Changeling,2365.338722,58020255
55000000,2008,168167691,Seven Pounds,6584.095246,113167691
55000000,2008,127906624,The Forbidden Kingdom,1615.351339,72906624
46000000,2002,113714830,Insomnia,4014.476504,67714830
27000000,1984,20158808,The NeverEnding Story,0.0,-6841192
42000000,1999,363889678,Notting Hill,2627.735292,321889678
50000000,2005,66002004,Herbie Fully Loaded,1073.803667,16002004
50000000,2005,161451538,The Ring Two,899.6542346,111451538
50000000,2005,44434439,Into the Blue,790.5607752,-5565561
50000000,2005,22944502,Domino,467.8106275,-27055498
50000000,2005,94000000,Syriana,3148.5481,44000000
50000000,2005,104478416,The Hitchhiker's Guide to the Galaxy,276.4751984,54478416
50000000,2005,110803676,The Dukes of Hazzard,740.5848387,60803676
50000000,2005,69425966,The Adventures of Sharkboy and Lavagirl,0.0,19425966
50000000,2005,42093706,Oliver Twist,831.7075573,-7906294
34000000,1992,48169908,Malcolm X,92.14500384,14169908
43000000,2000,80049764,Finding Forrester,3752.920564,37049764
30000000,1988,38413606,Midnight Run,415.7717226,8413606
38000000,1996,17380126,Extreme Measures,1930.972095,-20619874
38000000,1996,10300000,White Squall,101.3448634,-27700000
51000000,2006,72779000,Barnyard,936.0495873,21779000
40000000,1998,38172500,Quest for Camelot,1828.343489,-1827500
40000000,1998,54682547,Small Soldiers,406.1077371,14682547
45000000,2002,306776732,Chicago,1128.041389,261776732
45000000,2002,94935764,Changing Lanes,2150.847989,49935764
42000000,2000,32168970,Reindeer Games,1882.000823,-9831030
50000000,2006,61112916,The Shaggy Dog,1963.928708,11112916
51500000,2007,55112356,Eastern Promises,3420.982311,3612356
50000000,2006,55181129,The Ant Bully,3986.956613,5181129
50000000,2006,69834815,Curious George,2577.741374,19834815
50000000,2006,111340801,Underworld: Evolution,1060.093951,61340801
50000000,2006,132180323,Perfume: The Story of a Murderer,0.0,82180323
50000000,2006,97607453,Silent Hill,982.9548807,47607453
50000000,2006,49111202,The Black Dahlia,989.6642766,-888798
50000000,2006,88715192,Failure to Launch,1433.731563,38715192
34000000,1993,32255440,The Age of Innocence,831.9284169,-1744560
35000000,1994,99423521,Street Fighter,388.212912,64423521
31000000,1990,53208180,Arachnophobia,0.0,22208180
30000000,1989,70200000,Star Trek V: The Final Frontier,1138.547767,40200000
30000000,1989,45892212,Black Rain,848.1680623,15892212
38000000,1997,299288605,My Best Friend's Wedding,1960.652023,261288605
25000000,1983,65884703,Scarface,861.8220025,40884703
41300000,2000,106371651,The Whole Nine Yards,4670.531146,65071651
40000000,1999,672806292,The Sixth Sense,3526.877004,632806292
40000000,1999,128798265,The Talented Mr. Ripley,1338.754584,88798265
40000000,1999,96618699,8MM,2084.600625,56618699
45000000,2003,124914842,"Legally Blonde 2: Red, White & Blonde",717.6351812,79914842
52000000,2008,609841637,Mamma Mia!,3349.247715,557841637
42000000,2001,35402320,Original Sin,864.505428,-6597680
50000000,2007,32017803,Sunshine,226.2757495,-17982197
50000000,2007,90450008,Hairspray,2526.083461,40450008
50000000,2007,82169884,Hannibal Rising,222.0668826,32169884
53000000,2009,126690726,Law Abiding Citizen,1363.574521,73690726
35000000,1995,113374103,Species,789.0095875,78374103
35000000,1995,15000000,The Horseman on the Roof,0.0,-20000000
43000000,2002,68696770,The Sweetest Thing,3395.242885,25696770
37000000,1997,6482195,Switchback,1001.691028,-30517805
30000000,1990,199200000,The Hunt for Red October,3197.50897,169200000
25000000,1984,8613462,The Bounty,343.7525678,-16386538
25000000,1984,5778353,Sheena,0.0,-19221647
40000000,2000,144056873,The Beach,3436.940403,104056873
40000000,2000,55707411,Pay It Forward,1537.833711,15707411
40000000,2000,30199105,The Art of War,376.6585636,-9800895
40000000,2000,161834276,Scream 3,775.0036728,121834276
40000000,2000,36037909,Hanging Up,1393.170871,-3962091
45000000,2004,129394835,Resident Evil: Apocalypse,294.4116324,84394835
45000000,2004,21009180,Flight of the Phoenix,677.4300066,-23990820
28000000,1988,140767956,Die Hard,0.0,112767956
27000000,1987,38122105,The Running Man,804.3908851,11122105
42000000,2002,63781810,High Crimes,2584.20325,21781810
20000000,1977,303788635,Close Encounters of the Third Kind,2036.521803,283788635
47000000,2006,38085778,Happily N'Ever After,957.322369,-8914222
32000000,1993,36733909,Alive,568.4936561,4733909
36000000,1997,12532777,Gattaca,598.201243,-23467223
36000000,1997,74000000,Amistad,2434.850969,38000000
36000000,1997,50159144,Breakdown,686.1118495,14159144
30000000,1991,74787599,The Prince of Tides,69.76193363,44787599
30000000,1991,191502426,The Addams Family,2131.963622,161502426
38000000,1999,635096,Ride with the Devil,130.6011308,-37364904
38000000,1999,28121100,The Deep End of the Ocean,1428.574586,-9878900
38000000,1999,58401898,The Ninth Gate,291.1904523,20401898
25000000,1985,11137801,Return to Oz,0.0,-13862199
40000000,2001,91753202,Behind Enemy Lines,2228.292099,51753202
40000000,2001,65754228,Sweet November,1777.692244,25754228
40000000,2001,27053815,The Musketeer,153.381523,-12946185
40000000,2001,141069860,Shallow Hal,1334.885795,101069860
45000000,2005,92374674,Four Brothers,1628.16275,47374674
45000000,2005,38058335,The Producers,1709.012399,-6941665
45000000,2005,50871113,Unleashed,3205.093729,5871113
45000000,2005,56070433,Kicking & Screaming,1022.904939,11070433
41000000,2002,215000000,8 Mile,157.292828,174000000
20000000,1978,187884007,Jaws 2,1707.295543,167884007
50000000,2009,40828540,Gamer,1363.574521,-9171460
50000000,2009,106303988,Race to Witch Mountain,1018.522013,56303988
50000000,2009,60161391,The International,1127.715964,10161391
50000000,2009,12764201,Street Fighter: The Legend of Chun-Li,708.3240897,-37235799
50000000,2009,155446362,Knowing,3469.649525,105446362
50000000,2009,36348784,The Boat That Rocked,1348.762966,-13651216
50000000,2009,709827462,The Twilight Saga: New Moon,810.232579,659827462
33000000,1995,327311859,Se7en,1436.36325,294311859
35000000,1997,126216940,L.A. Confidential,1202.559372,91216940
35000000,1997,41954997,Donnie Brasco,1377.220521,6954997
35000000,1997,25105255,Midnight in the Garden of Good and Evil,0.0,-9894745
37000000,1999,48451803,Magnolia,529.9772358,11451803
25000000,1986,38748395,Little Shop of Horrors,0.0,13748395
25000000,1986,11000000,Big Trouble in Little China,372.2577443,-14000000
25000000,1986,79817939,The Golden Child,1037.676666,54817939
40000000,2002,22433915,City By The Sea,2371.674478,-17566085
40000000,2002,8493890,Big Trouble,1871.318831,-31506110
40000000,2002,18902015,FearDotCom,211.6286248,-21097985
40000000,2002,10959475,Extreme Ops,228.6424916,-29040525
40000000,2002,16872671,Life or Something Like It,1118.950086,-23127329
45000000,2006,184376254,Inside Man,2592.073866,139376254
45000000,2006,82800000,Firewall,7137.995039,37800000
45000000,2006,38399961,Last Holiday,981.8493641,-6600039
45000000,2006,178262620,Scary Movie 4,400.4402763,133262620
22000000,1982,77737889,Gandhi,0.0,55737889
42000000,2004,171963386,Along Came Polly,1493.6708,129963386
20000000,1979,35841901,The Black Hole,106.9703646,15841901
32000000,1995,18552460,The Quick and the Dead,1418.930632,-13447540
43000000,2005,91974818,The Skeleton Key,473.2774832,48974818
43000000,2005,56681566,Elektra,138.815474,13681566
43000000,2005,154749918,Monster-in-Law,1367.006392,111749918
38000000,2001,207283925,The Fast and the Furious,964.8372365,169283925
25000000,1987,76270454,The Untouchables,2168.398307,51270454
40000000,2003,244931766,Love Actually,255.0764374,204931766
40000000,2003,190212113,Cheaper by the Dozen,231.5775337,150212113
40000000,2003,160583018,Johnny English,445.900911,120583018
40000000,2003,19322135,Duplex,2015.232892,-20677865
40000000,2003,141591324,Gothika,1311.004052,101591324
45000000,2007,175372502,The Bucket List,3316.278037,130372502
45000000,2007,4607608,Love in the Time of Cholera,525.8264151,-40392392
45000000,2007,148412065,Resident Evil: Extinction,496.0786683,103412065
24000000,1986,133000000,Star Trek IV: The Voyage Home,885.1467976,109000000
42000000,2005,24127895,Lord of War,3071.534976,-17872105
35000000,1999,40263020,Blast from the Past,329.7837337,5263020
32000000,1996,152036382,Phenomenon,1014.317692,120036382
36000000,2000,3003296,Isn't She Great,322.4531046,-32996704
37000000,2001,165335153,The Princess Diaries,517.7135687,128335153
30000000,1994,51132598,The Naked Gun 33â? The Final Insult,217.9619128,21132598
30000000,1994,160638883,Legends of the Fall,1107.269658,130638883
30000000,1994,350448145,Speed,83.36415706,320448145
38000000,2002,119723358,Spy Kids 2: The Island of Lost Dreams,1134.109643,81723358
38000000,2002,51801187,Enough,864.7895214,13801187
21000000,1982,177200000,Tootsie,1001.125182,156200000
25000000,1988,412800000,Rain Man,984.9944609,387800000
40000000,2004,46546197,Torque,827.9070175,6546197
40000000,2004,92913171,Secret Window,1964.314661,52913171
40000000,2004,95149435,The Princess Diaries 2: Royal Engagement,654.3223482,55149435
40000000,2004,26155781,The Whole Ten Yards,5184.698853,-13844219
40000000,2004,124731534,Ray,228.7944719,84731534
45000000,2008,42487390,Bangkok Dangerous,3499.344412,-2512610
45000000,2008,101702060,Journey to the Center of the Earth,941.2390791,56702060
45000000,2008,9323833,Miracle at St. Anna,32.03722508,-35676167
45000000,2008,73762516,Death Race,596.6033184,28762516
28000000,1992,504050219,Aladdin,1502.354827,476050219
27000000,1991,96900000,Star Trek VI: The Undiscovered Country,1239.995977,69900000
34200000,1999,234801895,Big Daddy,391.6691322,200601895
8250000,1951,30000000,Quo Vadis,0.0,21750000
20000000,1981,2297493,Under the Rainbow,3902.128517,-17702507
30250000,1995,115101622,Get Shorty,1418.930632,84851622
32000000,1997,3566637,Cats Don't Dance,0.0,-28433363
26000000,1990,61489265,Flatliners,186.807031,35489265
35866397,2001,20217080,Winged Migration,0.0,-15649317
30000000,1995,373554033,Toy Story,2377.875526,343554033
30000000,1995,254134910,Babe,0.0,224134910
30000000,1995,24048000,Virtuosity,965.5063687,-5952000
30000000,1995,212385533,Ace Ventura: When Nature Calls,1365.63237,182385533
38000000,2003,197011982,Spy Kids 3-D: Game Over,1348.437143,159011982
39000000,2004,6614280,Against the Ropes,1326.775478,-32385720
40000000,2005,117195061,Corpse Bride,2223.95669,77195061
40000000,2005,46442528,Get Rich or Die Tryin',90.96849601,6442528
40000000,2005,68766121,House of Wax,43.76665055,28766121
40000000,2005,158733820,Sin City,129.5539211,118733820
40000000,2005,31670620,Rent,139.263467,-8329380
45000000,2009,57881056,Aliens in the Attic,0.0,12881056
28000000,1993,669276,The Thief and the Cobbler,3329.157516,-27330724
28000000,1993,39514713,Hocus Pocus,64.58812247,11514713
19000000,1980,44017374,The Shining,339.4359458,25017374
20000000,1982,79114085,Conan the Barbarian,1453.775424,59114085
33000000,1999,310940086,Austin Powers: The Spy Who Shagged Me,336.4891858,277940086
35000000,2001,147934180,Spy Kids,864.505428,112934180
35000000,2001,29400000,The Pledge,2081.895087,-5600000
35000000,2001,74558115,From Hell,652.5421291,39558115
35000000,2001,94728529,The Wedding Planner,893.5518021,59728529
35000000,2001,13678913,American Outlaws,86.33859142,-21321087
36000000,2002,102244770,John Q,2253.116885,66244770
23000000,1987,51881013,Jaws: The Revenge,487.9276502,28881013
23000000,1987,43984230,The Last Emperor,177.8634737,20984230
39000000,2005,38869464,Serenity,499.727657,-130536
25000000,1990,46836394,GoodFellas,337.8186457,21836394
17000000,1977,8720000,Damnation Alley,0.0,-8280000
40000000,2006,23937870,Stormbreaker,4798.87819,-16062130
40000000,2006,138259062,Big Momma's House 2,1052.916328,98259062
40000000,2006,109676311,The Prestige,1223.144674,69676311
40000000,2006,120175290,Apocalypto,0.0,80175290
40000000,2006,60474340,Marie Antoinette,3158.839774,20474340
40000000,2006,114830111,The Lake House,3768.259685,74830111
40000000,2006,86915017,The Illusionist,909.4388453,46915017
40000000,2006,120455994,Eight Below,835.7614011,80455994
22700000,1987,38119483,Spaceballs,161.8443151,15419483
34000000,2001,19693891,Summer Catch,267.9568309,-14306109
33000000,2000,104155843,The Cell,526.2366799,71155843
35000000,2002,45479110,Queen of the Damned,144.4510975,10479110
35000000,2002,29882645,The Four Feathers,682.5826685,-5117355
35000000,2002,75395048,The Count of Monte Cristo,313.0733452,40395048
35000000,2002,16838910,Femme Fatale,1134.109643,-18161090
35000000,2002,120072577,The Pianist,158.3002836,85072577
35000000,2002,68349884,Ghost Ship,457.787841,33349884
36000000,2003,44350926,A Man Apart,1666.979576,8350926
41677699,2008,187479518,Ponyo,0.0,145801819
37000000,2004,96455697,13 Going on 30,41.69695822,59455697
37000000,2004,113086475,White Chicks,213.0206674,76086475
30000000,1997,51376861,Mortal Kombat: Annihilation,357.4785756,21376861
25000000,1991,78000000,Teenage Mutant Ninja Turtles II: The Secret of the Ooze,154.9210341,53000000
40000000,2007,145896422,Music and Lyrics,2596.52042,105896422
40000000,2007,41797066,Aliens vs Predator: Requiem,0.0,1797066
40000000,2007,62771059,The Reaping,578.443341,22771059
18000000,1980,23000000,Raging Bull,248.8522827,5000000
18000000,1980,538400000,The Empire Strikes Back,2399.596647,520400000
28000000,1995,31596911,Rob Roy,730.6710169,3596911
27000000,1994,101646581,Timecop,85.50736687,74646581
35000000,2003,11560806,The Order,714.0579083,-23439194
35000000,2003,131282949,School of Rock,1263.679336,96282949
32000000,2000,48814909,Men of Honor,1648.536761,16814909
26000000,1993,206678440,Philadelphia,694.0260561,180678440
30000000,1998,19204929,The Replacement Killers,466.5266335,-10795071
30000000,1998,82150642,Elizabeth,0.0,52150642
30000000,1998,100491683,The Rugrats Movie,1221.039178,70491683
30000000,1998,29202884,Bulworth,346.9836965,-797116
30000000,1998,9898412,Very Bad Things,1185.042164,-20101588
38000000,2006,29907685,Pulse,0.0,-8092315
25000000,1992,411006740,The Bodyguard,2330.623628,386006740
40000000,2008,9793496,The Express,1423.315707,-30206504
40000000,2008,7400000,The Children of Huang Shi,344.5561745,-32600000
40000000,2008,84601681,Made of Honor,696.070583,44601681
40000000,2008,151161491,Vantage Point,1423.315707,111161491
18000000,1981,12000000,Blow Out,541.2605685,-6000000
18000000,1981,2945600,The Legend of the Lone Ranger,0.0,-15054400
18000000,1981,14110013,Dragonslayer,0.0,-3889987
18000000,1981,389925971,Raiders of the Lost Ark,3923.652266,371925971
28000000,1996,16900000,Michael Collins,673.4059187,-11100000
41000000,2009,91636986,"I Love You, Man",466.4097603,50636986
24000000,1991,41895491,The Fisher King,794.7744001,17895491
20000000,1985,18432000,Ladyhawke,208.6764776,-1568000
33000000,2002,102984862,Resident Evil,325.9772522,69984862
35000000,2004,22034832,Little Black Book,622.9907429,-12965168
35000000,2004,36098382,Jersey Girl,2643.255232,1098382
32000000,2001,40222729,Hardball,1777.692244,8222729
26000000,1994,36800000,Highlander: The Final Dimension,108.2987988,10800000
31000000,2000,68106245,Frequency,457.7803888,37106245
11000000,1965,111858363,Doctor Zhivago,0.0,100858363
38000000,2007,5410749,Virgin Territory,2078.086041,-32589251
10000000,1962,50100000,The Longest Day,0.0,40100000
25000000,1993,441286195,Mrs. Doubtfire,2505.02476,416286195
25000000,1993,56505065,Tombstone,838.4646921,31505065
40000000,2009,46471023,Fantastic Mr. Fox,3316.277271,6471023
40000000,2009,28169671,Cirque du Freak: The Vampire's Assistant,558.0537271,-11830329
40000000,2009,129540499,Julie & Julia,2278.959221,89540499
40000000,2009,317375031,The Proposal,2014.700413,277375031
40000000,2009,177259441,He's Just Not That Into You,2819.855832,137259441
40000000,2009,28972508,Shorts,132.2368565,-11027492
40000000,2009,186167139,The Final Destination,0.0,146167139
40000000,2009,12206028,Whiteout,1444.484821,-27793972
40000000,2009,60462347,Ninja Assassin,206.1957466,20462347
18000000,1982,70687344,Firefox,352.1349001,52687344
28000000,1997,5684789,Kundun,0.0,-22315211
28000000,1997,8345056,A Simple Wish,95.20784947,-19654944
27000000,1996,231976425,The English Patient,702.6758343,204976425
27000000,1996,25023434,Kingpin,66.53188287,-1976566
35000000,2005,19294901,Cursed,532.6167423,-15705099
35000000,2005,19478106,Valiant,3059.408255,-15521894
35000000,2005,68915888,Guess Who,394.5891966,33915888
35000000,2005,86369815,Sky High,791.0767313,51369815
35000000,2005,25224242,North Country,964.190716,-9775758
32000000,2002,55157539,The Mothman Prophecies,1790.119519,23157539
31000000,2001,24185781,Hearts in Atlantis,2007.801044,-6814219
23000000,1991,7434726,Harley Davidson and the Marlboro Man,15.15631158,-15565274
23000000,1991,86930411,The Naked Gun 2Â½: The Smell of Fear,44.45892445,63930411
30000000,2000,173959438,Big Momma's House,440.321877,143959438
30000000,2000,47126295,High Fidelity,698.4352002,17126295
30000000,2000,136706683,Remember the Titans,1958.337866,106706683
30000000,2000,45554533,The Tigger Movie,0.0,15554533
30000000,2000,37036004,Keeping the Faith,771.3234122,7036004
39000000,2009,101229792,The Time Traveler's Wife,1155.002781,62229792
29000000,1999,50041732,Stigmata,824.0427733,21041732
25000000,1994,28341469,The Shawshank Redemption,1411.726408,3341469
25000000,1994,22200000,Don Juan DeMarco,1378.308384,-2800000
25000000,1994,48063435,The Shadow,580.7035049,23063435
17000000,1981,2000000,Roar,0.0,-15000000
19000000,1985,381109762,Back to the Future,99.75158861,362109762
22000000,1990,505000000,Ghost,339.0426267,483000000
22000000,1990,424208848,Dances with Wolves,174.020706,402208848
27000000,1997,60527873,Kiss the Girls,2434.850969,33527873
20000000,1987,299965036,Beverly Hills Cop II,1211.515736,279965036
33000000,2004,54700105,The Punisher,2400.693104,21700105
35000000,2006,42064105,A Good Year,1736.523418,7064105
35000000,2006,10496317,Bandidas,670.3744345,-24503683
35000000,2006,15304890,The Fountain,1223.144674,-19695110
35000000,2006,326551094,The Devil Wears Prada,930.737026,291551094
35000000,2006,12506188,Zoom,1963.928708,-22493812
32000000,2003,52277485,Radio,1431.539352,20277485
32000000,2003,173398518,Elf,819.2626086,141398518
26000000,1996,116400000,The First Wives Club,557.9031866,90400000
31000000,2002,177394432,Hero,360.1157639,146394432
37000000,2008,392616625,Twilight,314.8776678,355616625
37000000,2008,63800345,Space Chimps,663.7738446,26800345
37000000,2008,100076342,Nim's Island,1442.938538,63076342
37000000,2008,163720069,Burn After Reading,5556.699604,126720069
12000000,1970,89800000,Patton,42.02670119,77800000
30000000,2001,287553595,American Pie 2,418.2703142,257553595
30000000,2001,23619609,The Glass House,573.0468603,-6380391
30000000,2001,18195610,Antitrust,391.3263224,-11804390
38000000,2009,205298907,The Ugly Truth,1363.574521,167298907
25000000,1995,4064495,Tank Girl,0.0,-20935505
26500000,1997,159375308,Princess Mononoke,0.0,132875308
18000000,1984,87000000,Star Trek III: The Search for Spock,693.8330158,69000000
18000000,1984,51973029,Amadeus,0.0,33973029
18000000,1984,100000000,Conan the Destroyer,213.7115073,82000000
28000000,1999,8888143,"Mystery, Alaska",75.0967357,-19111857
36500000,2008,21834845,The Inhabited Island,0.0,-14665155
15000000,1978,50000000,The Deer Hunter,101.0739375,35000000
25530000,1996,20080020,Flipper,656.4281077,-5449980
27000000,1998,27200316,Dark City,199.0527729,200316
27000000,1998,76000000,The Newton Boys,606.3852327,49000000
20000000,1988,13854000,My Stepmother is an Alien,591.2836472,-6146000
35000000,2007,63215872,Lions for Lambs,7889.21116,28215872
35000000,2007,18317151,Walk Hard: The Dewey Cox Story,387.5026516,-16682849
35000000,2007,69307224,License to Wed,4691.174525,34307224
32000000,2004,50907422,Team America: World Police,0.0,18907422
30000000,2002,105834556,About Schmidt,2073.829873,75834556
30000000,2002,33013805,Confessions of a Dangerous Mind,4163.114089,3013805
30000000,2002,27674124,The Quiet American,924.208671,-2325876
30000000,2002,180622424,Sweet Home Alabama,344.4219281,150622424
25000000,1996,10070000,Mrs. Winterbourne,83.63378356,-14930000
25000000,1996,51702483,Maximum Risk,462.7537924,26702483
25000000,1996,17193231,Fled,111.6114957,-7806769
9400000,1963,60000000,"It's a Mad, Mad, Mad, Mad World",127.2515238,50600000
13000000,1974,47542841,The Godfather: Part II,889.6724359,34542841
28000000,2000,33000337,Dracula 2000,577.2157119,5000337
28000000,2000,90449929,Bring It On,561.3861944,62449929
18500000,1986,183316455,Aliens,277.4726085,164816455
17900000,1985,6948633,Red Sonja,672.8973991,-10951367
24000000,1995,182016617,The Bridges of Madison County,696.5430537,158016617
27000000,1999,56870414,Lake Placid,2009.9023,29870414
34000000,2007,95608995,TMNT,1041.348033,61608995
33000000,2006,62022014,Snakes on a Plane,3745.331713,29022014
14000000,1977,185438673,The Spy Who Loved Me,873.372044,171438673
14000000,1977,30749142,Exorcist II: The Heretic,1490.615693,16749142
35000000,2008,25871834,Superhero Movie,202.212073,-9128166
35000000,2008,170000000,What Happens in Vegas,6220.808033,135000000
35000000,2008,75225693,Revolutionary Road,4548.639108,40225693
35000000,2008,72436439,Mirrors,426.4935762,37436439
35000000,2008,69823199,21,2002.145363,34823199
35000000,2008,85416905,Max Payne,1770.232332,50416905
35000000,2008,32483410,Untraceable,817.7595786,-2516590
35000000,2008,43650785,Welcome Home Roscoe Jenkins,1450.749111,8650785
32000000,2005,60740827,A History of Violence,3453.339751,28740827
32000000,2005,97918663,Are We There Yet?,969.7307071,65918663
32000000,2005,85167639,Transporter 2,397.8462835,53167639
26000000,1998,65705772,Ever After: A Cinderella Story,1549.793718,39705772
31000000,2004,27388767,Ella Enchanted,1299.143582,-3611233
31000000,2004,41512007,Wimbledon,2696.42792,10512007
23000000,1994,351583407,The Mask,0.0,328583407
30000000,2003,180949000,Kill Bill: Vol. 1,529.2092256,150949000
30000000,2003,15368897,Alex & Emma,904.7164465,-14631103
30000000,2003,114908830,Freddy vs. Jason,365.9187105,84908830
30000000,2003,90259536,Identity,846.5879154,60259536
29000000,2002,16930185,Serving Sara,312.4051566,-12069815
25000000,1997,100000000,Spice World,0.0,75000000
16000000,1982,53977250,The Verdict,976.075511,37977250
18000000,1986,41382841,Peggy Sue Got Married,0.0,23382841
28000000,2001,14010832,Ghosts of Mars,647.6555371,-13989168
28000000,2001,77516304,Serendipity,759.9427367,49516304
28000000,2001,60780981,Zoolander,1350.429374,32780981
15000000,1980,67182787,Coal Miner's Daughter,0.0,52182787
22000000,1993,10696210,RoboCop 3,126.8974865,-11303790
22000000,1993,321365567,Schindler's List,170.6201072,299365567
10500000,1968,68700000,2001: A Space Odyssey,0.0,58200000
20000000,1990,53000000,Edward Scissorhands,186.807031,33000000
35000000,2009,27409889,The Young Victoria,445.5835153,-7590111
35000000,2009,92219310,Old Dogs,4535.775271,57219310
35000000,2009,155545279,Hannah Montana: The Movie,396.364512,120545279
35000000,2009,459270619,The Hangover,19.92635851,424270619
35000000,2009,91353501,Underworld: Rise of the Lycans,327.6122282,56353501
35000000,2009,73034460,Hotel for Dogs,291.4663227,38034460
32000000,2006,5914908,The Good German,2706.43621,-26085092
32000000,2006,80197993,Nacho Libre,1186.834093,48197993
11000000,1970,2200000,The Molly Maguires,2177.219769,-8800000
30000000,2004,152159461,Kill Bill: Vol. 2,748.6974953,122159461
30000000,2004,611899420,The Passion of the Christ,507.9412526,581899420
30000000,2004,21800302,Mr. 3000,188.4407679,-8199698
30000000,2004,140161792,The SpongeBob SquarePants Movie,9.440303384,110161792
30000000,2004,13001257,Wicker Park,1014.368132,-16998743
30000000,2004,216763646,Million Dollar Baby,2955.917212,186763646
30000000,2004,14000000,Welcome to Mooseport,2303.85075,-16000000
29000000,2003,98185582,Once Upon a Time in Mexico,1348.437143,69185582
25000000,1998,289317794,Shakespeare in Love,589.5335667,264317794
25000000,1998,50671850,Bride of Chucky,286.7382196,25671850
25000000,1998,21567853,He Got Game,1411.509965,-3432147
25000000,1998,777423,Without Limits,392.4006215,-24222577
18000000,1987,98235548,Predator,804.3908851,80235548
19000000,1989,110879513,Sea of Love,888.6687543,91879513
22000000,1994,189833357,The Santa Clause,1355.375052,167833357
24000000,1997,172363301,Scream 2,514.3860506,148363301
33000000,2008,269958228,Gran Torino,1278.497542,236958228
26000000,2000,28780255,Boiler Room,849.7531357,2780255
26000000,2000,71868327,"O Brother, Where Art Thou?",759.6932112,45868327
30000000,2005,18618284,An Unfinished Life,3205.093729,-11381716
30000000,2005,58405313,Must Love Dogs,939.9068027,28405313
30000000,2005,15007991,The Cave,227.364092,-14992009
30000000,2005,50451307,Fever Pitch,2581.765189,20451307
30000000,2005,42886719,A Lot Like Love,394.5891966,12886719
30000000,2005,192452832,The Curse of the Were-Rabbit,1729.470269,162452832
30000000,2005,35294470,Assault on Precinct 13,2560.101173,5294470
30000000,2005,30536013,The New World,1147.96817,536013
30000000,2005,93772522,Racing Stripes,618.5346768,63772522
30000000,2005,25473093,Dark Water,854.7721397,-4526907
30000000,2005,76669806,Coach Carter,3620.5376,46669806
30000000,2005,27610873,Goal!: The Dream Begins,0.0,-2389127
21000000,1993,42000000,Teenage Mutant Ninja Turtles III,161.4855541,21000000
29000000,2004,115603229,The Notebook,85.45334106,86603229
10000000,1968,37402877,Oliver!,0.0,27402877
25000000,1999,15156200,The Corruptor,164.362219,-9843800
25000000,1999,4152230,Idle Hands,5.098718089,-20847770
25000000,1999,13000000,Brokedown Palace,2009.9023,-12000000
17000000,1986,6735922,Nine 1/2 Weeks,410.8785564,-10264078
18000000,1988,151668774,Big,170.3744178,133668774
28000000,2003,58795814,Agent Cody Banks,80.87504475,30795814
15000000,1982,125212904,First Blood,426.9775201,110212904
15000000,1982,19629760,The Thing,142.7106626,4629760
22000000,1995,110627965,The Net,677.8069372,88627965
24000000,1998,4562146,Meet the Deedles,1172.060934,-19437854
27000000,2002,129000000,About a Boy,1698.852383,102000000
20000000,1992,121697323,Wayne's World,0.0,101697323
33000000,2009,20645327,Pandorum,1595.951227,-12354673
33000000,2009,14000000,Micmacs,68.01527952,-19000000
32000000,2008,113019290,The Reader,3489.127575,81019290
9500000,1967,111584787,You Only Live Twice,1823.514486,102084787
30000000,2006,31070211,Ultraviolet,464.0977024,1070211
30000000,2006,34742066,Take the Lead,1878.707877,4742066
30000000,2006,53653224,Stranger Than Fiction,1932.028172,23653224
30000000,2006,35078241,Miss Potter,4798.87819,5078241
30000000,2006,495303,Idiocracy,539.011651,-29504697
30000000,2006,41480851,Gridiron Gang,510.9287029,11480851
29000000,2005,21126225,The Jacket,872.2315843,-7873775
25000000,2000,152500343,Chocolat,422.8883215,127500343
25000000,2000,15843608,Highlander: Endgame,297.8157917,-9156392
25000000,2000,24362772,The Next Best Thing,614.7407697,-637228
25000000,2000,91036760,Romeo Must Die,8.45456237,66036760
17000000,1987,19300000,Superman IV: The Quest for Peace,1459.257879,2300000
18000000,1989,26828365,Glory,234.9535825,8828365
28000000,2004,102356381,Dawn of the Dead,138.5120373,74356381
28000000,2004,30016165,Laws of Attraction,3531.254639,2016165
28000000,2004,64445708,Miracle,717.4171281,36445708
15000000,1983,61399552,National Lampoon's Vacation,118.2057702,46399552
19000000,1991,272742922,The Silence of the Lambs,433.6311545,253742922
24000000,1999,16290976,Muppets from Space,0.0,-7709024
24000000,1999,8434146,Play It to the Bone,782.5346567,-15565854
14000000,1981,85000000,Das Boot,0.0,71000000
14000000,1981,439564,Sphinx,0.0,-13560436
32000000,2009,27635305,The Road,3366.041877,-4364695
26000000,2002,38793283,Clockstoppers,155.9838341,12793283
23000000,1998,369884651,There's Something About Mary,1185.042164,346884651
23000000,1998,185991646,The Waterboy,73.58747712,162991646
30000000,2007,219076518,Knocked Up,149.2032907,189076518
30000000,2007,75505973,30 Days of Night,1110.773485,45505973
30000000,2007,129266061,Atonement,2119.978884,99266061
30000000,2007,14711793,The Assassination of Jesse James by the Coward Robert Ford,5249.473875,-15288207
30000000,2007,156835339,P.S. I Love You,1078.580019,126835339
30000000,2007,16930884,88 Minutes,1630.513912,-13069116
30000000,2007,77566815,The Number 23,4521.187862,47566815
25000000,2001,64437847,Kiss of the Dragon,147.4604954,39437847
25000000,2001,281929795,Bridget Jones's Diary,1283.749678,256929795
25000000,2001,80936232,Jimmy Neutron: Boy Genius,0.0,55936232
16000000,1986,5900000,Highlander,0.985859669,-10100000
18000000,1990,476684675,Home Alone,54.92817087,458684675
28000000,2005,121147947,Pride & Prejudice,632.6171082,93147947
28000000,2005,186438883,Walk the Line,1943.229499,158438883
15000000,1984,17080167,Firestarter,2141.895588,2080167
15000000,1984,316360478,Beverly Hills Cop,242.0249539,301360478
24000000,2000,12372410,Ready to Rumble,590.5598932,-11627590
24000000,2000,36609995,Return to Me,318.4899716,12609995
24000000,2000,13700000,The Ladies Man,35.76858777,-10300000
27000000,2004,13000000,Suspect Zero,2546.316785,-14000000
27000000,2004,115505027,Closer,4019.333515,88505027
27000000,2004,21148829,Mindhunters,134.3112667,-5851171
20000000,1994,305070,Rapa Nui,0.0,-19694930
26000000,2003,90426405,Final Destination 2,103.8871815,64426405
26000000,2003,110230332,Freaky Friday,1007.302351,84230332
23000000,1999,18653615,Anywhere But Here,278.3022261,-4346385
23000000,1999,10827816,The End of the Affair,1356.2022,-12172184
30000000,2008,105173115,Forgetting Sarah Marshall,39.74326135,75173115
30000000,2008,160259319,27 Dresses,480.2782863,130259319
30000000,2008,22211426,Doomsday,97.94002438,-7788574
30000000,2008,84646831,Meet the Spartans,347.5947378,54646831
30000000,2008,63833449,Baby Mama,238.077823,33833449
30000000,2008,68369434,The X Files: I Want to Believe,338.7484197,38369434
30000000,2008,31148328,Pride and Glory,1797.107783,1148328
25000000,2002,51842679,Blue Crush,325.9772522,26842679
25000000,2002,41604473,Undercover Brother,322.3600291,16604473
25000000,2002,10719357,Abandon,428.1431904,-14280643
25000000,2002,41597830,The Hours,918.208766,16597830
25000000,2002,17000000,Punch-Drunk Love,743.2521046,-8000000
16000000,1987,30857814,The Princess Bride,76.4059273,14857814
28000000,2006,38159905,Just My Luck,472.2246557,10159905
15000000,1985,146292009,The Color Purple,0.0,131292009
19000000,1993,2119994,The Nutcracker,0.0,-16880006
24000000,2001,14782676,Out Cold,42.67871376,-9217324
20000000,1995,7563728,Hackers,0.0,-12436272
20000000,1995,21284514,To Die For,315.7088292,1284514
9000000,1968,2500000,Barbarella,0.0,-6500000
26000000,2004,90574188,Anchorman: The Legend of Ron Burgundy,475.0194401,64574188
26000000,2004,28818995,Agent Cody Banks 2: Destination London,340.3271557,2818995
8200000,1965,286214286,The Sound of Music,480.129976,278014286
11000000,1975,20000000,Barry Lyndon,0.0,9000000
23000000,2000,53302314,Final Destination,6.927515757,30302314
23000000,2000,53187659,Pitch Black,849.7531357,30187659
30000000,2009,90810892,Drag Me to Hell,599.0867266,60810892
30000000,2009,48428063,9,558.0537271,18428063
30000000,2009,64352607,The Imaginarium of Doctor Parnassus,5434.037669,34352607
30000000,2009,33333531,The Box,6294.94149,3333531
30000000,2009,95714875,My Sister's Keeper,6294.94149,65714875
30000000,2009,114663461,Bride Wars,1226.162575,84663461
30000000,2009,210819611,District 9,0.0,180819611
25000000,2003,56489558,Cradle 2 the Grave,623.5522963,31489558
25000000,2003,156822020,Mystic River,1583.934562,131822020
18000000,1992,358991681,Home Alone 2: Lost in New York,1168.557693,340991681
28000000,2007,92601050,No Reservations,2426.214275,64601050
16400000,1989,235860116,Dead Poets Society,288.7604333,219460116
15000000,1986,356830601,Top Gun,173.387669,341830601
27000000,2006,56308881,Lucky Number Slevin,5086.848041,29308881
26000000,2005,57891803,Red Eye,417.6601745,31891803
26000000,2005,109449237,The 40 Year Old Virgin,224.2578447,83449237
27500000,2007,24748670,Rendition,1167.102158,-2751330
23000000,2001,36642838,Joy Ride,64.22406947,13642838
12000000,1979,54000000,Prophecy,370.2643498,42000000
29000000,2009,309208309,The Blind Side,2014.700413,280208309
25000000,2004,30411183,The Girl Next Door,68.39632552,5411183
25000000,2004,20796847,EuroTrip,0.0,-4203153
25000000,2004,116766556,Finding Neverland,3151.2189,91766556
25000000,2004,30114487,Godsend,2375.196281,5114487
25000000,2004,56422687,Cellular,945.2947881,31422687
16000000,1989,92823546,When Harry Met Sally...,4622.676807,76823546
28000000,2008,92380927,Role Models,842.1011978,64380927
15000000,1987,43848069,Wall Street,347.9860675,28848069
19000000,1995,141407024,Bad Boys,0.0,122407024
22000000,2000,13555988,The Little Vampire,0.0,-8444012
24000000,2003,87055349,Old School,420.2215615,63055349
20000000,1997,10686841,Deconstructing Harry,178.3937903,-9313159
20000000,1997,60000000,Selena,65.17408934,40000000
20000000,1997,13801755,The Man Who Knew Too Little,300.7198708,-6198245
26000000,2006,14821658,Little Children,3270.999531,-11178342
11000000,1977,775398007,Star Wars,0.0,764398007
21000000,1999,17762705,The Rage: Carrie 2,56.47394627,-3237295
25000000,2005,39053061,The Sisterhood of the Traveling Pants,0.0,14053061
25000000,2005,36351350,Beauty Shop,951.7883144,11351350
25000000,2005,27645491,Ice Princess,1470.924094,2645491
25000000,2005,82466670,The Constant Gardener,1729.470269,57466670
25000000,2005,15431177,The Greatest Game Ever Played,0.0,-9568823
25000000,2005,13411957,Lords of Dogtown,43.85791707,-11588043
25000000,2005,122489822,Nanny McPhee,598.5019851,97489822
25000000,2005,122644820,Hide and Seek,3803.501904,97644820
25000000,2005,2405420,BloodRayne,831.7075573,-22594580
18000000,1994,5887457,Ed Wood,168.0741986,-12112543
15000000,1988,216614388,Twins,1111.513644,201614388
15000000,1988,73326666,Beetlejuice,0.0,58326666
19000000,1996,25836616,From Dusk Till Dawn,330.7336146,6836616
22000000,2001,84772742,The Animal,107.1063021,62772742
22000000,2001,92542418,I Am Sam,1137.780936,70542418
22000000,2001,33788161,Jay and Silent Bob Strike Back,1421.619609,11788161
22000000,2001,19351569,Saving Silverman,418.2703142,-2648431
22000000,2001,5271666,Glitter,0.0,-16728334
24000000,2004,234710455,Howl's Moving Castle,0.0,210710455
27000000,2008,101624843,Pineapple Express,2300.256383,74624843
27000000,2008,44352417,The Sisterhood of the Traveling Pants 2,104.3563659,17352417
27000000,2008,17286299,How to Lose Friends & Alienate People,190.1657331,-9713701
20000000,1998,23875127,American History X,117.4164329,3875127
20000000,1998,37672350,How Stella Got Her Groove Back,1221.039178,17672350
20000000,1998,18253415,Simon Birch,2774.695702,-1746585
20000000,1998,67200000,Wild Things,1293.805278,47200000
9000000,1971,83304330,Fiddler on the Roof,0.0,74304330
23000000,2003,76488889,Bad Santa,1086.510934,53488889
12000000,1981,55260558,Quest for Fire,0.0,43260558
25000000,2006,117719158,Final Destination 3,0.0,92719158
25000000,2006,11772461,The Hoax,2107.282202,-13227539
25000000,2006,135330182,Babel,5184.306088,110330182
13800000,1986,52293982,The Color of Money,1010.905142,38493982
18000000,1995,122195920,Mortal Kombat,97.33924486,104195920
15000000,1989,30050028,Road House,91.60860179,15050028
27000000,2009,29000000,Case 39,2776.514073,2000000
14000000,1987,320145693,Fatal Attraction,0.0,306145693
21150000,2001,39438674,Crocodile Dundee in Los Angeles,607.9938712,18288674
11000000,1979,104931801,Alien,0.0,93931801
23000000,2004,16123851,Vanity Fair,785.466627,-6876149
23000000,2004,12,Chasing Liberty,61.66121298,-22999988
12000000,1982,96800000,Star Trek II: The Wrath of Khan,451.6603875,84800000
21000000,2001,28008462,The Tailor of Panama,3046.322162,7008462
21000000,2001,71441250,The Royal Tenenbaums,2228.292099,50441250
25000000,2007,40452643,War,720.0381709,15452643
25000000,2007,77208711,There Will Be Blood,434.0864903,52208711
25000000,2007,59192128,Good Luck Chuck,371.1985955,34192128
25000000,2007,94679598,1408,3758.406099,69679598
25000000,2007,66122026,August Rush,796.5358756,41122026
25000000,2007,171600000,No Country for Old Men,3567.95479,146600000
25000000,2007,92991835,Michael Clayton,2653.917883,67991835
25000000,2007,229736344,Mr. Bean's Holiday,223.4645252,204736344
15000000,1990,201957688,Kindergarten Cop,1553.854889,186957688
22000000,2003,68296293,Open Range,3399.709514,46296293
22000000,2003,95708457,Underworld,832.2897247,73708457
24000000,2006,23321954,Alatriste,3464.64329,-678046
24000000,2006,155721132,Rocky Balboa,2234.920336,131721132
8000000,1969,20000000,Sweet Charity,142.0308793,12000000
20000000,2000,27728118,Love & Basketball,0.0,7728118
14000000,1988,34670720,Dangerous Liaisons,761.5360734,20670720
26000000,2009,183293131,Paul Blart: Mall Cop,577.5358942,157293131
26000000,2009,43318349,Brothers,3709.997112,17318349
12000000,1983,30400000,Yentl,0.0,18400000
12000000,1983,79567667,WarGames,0.0,67567667
25100000,2008,29506464,W.,516.668827,4406464
21000000,2002,10011050,Moonlight Mile,2155.763894,-10988950
21000000,2002,43928932,The Transporter,268.9466155,22928932
25000000,2008,11207130,Stop-Loss,445.6245753,-13792870
25000000,2008,6673422,What Just Happened,5960.773773,-18326578
25000000,2008,170764026,Cloverfield,49.9619451,145764026
25000000,2008,19844979,Blindness,770.9269197,-5155021
25000000,2008,226830568,Taken,2495.642733,201830568
25000000,2008,14109284,Disaster Movie,0.0,-10890716
25000000,2008,70442940,The House Bunny,619.9464337,45442940
18000000,1997,8038061,The Ice Storm,865.0471092,-9961939
18500000,1998,10680275,Fear and Loathing in Las Vegas,279.0354952,-7819725
15000000,1991,30102717,Double Impact,26.15257923,15102717
19000000,1999,40846082,House on Haunted Hill,638.344708,21846082
24000000,2007,99965753,Hitman,871.1394902,75965753
5000000,1954,28200000,"20,000 Leagues Under the Sea",0.0,23200000
5000000,1954,15000000,The Egyptian,233.9434863,10000000
14000000,1989,161001698,Born on the Fourth of July,1917.803924,147001698
11000000,1981,31672907,History of the World: Part I,93.22249958,20672907
19800000,2001,87754044,Gosford Park,36.71377352,67954044
12305523,1985,36230219,Mad Max Beyond Thunderdome,358.5658727,23924696
25000000,2009,20719451,Mao's Last Dancer,0.0,-4280549
25000000,2009,10589102,The Bad Lieutenant: Port of Call - New Orleans,3469.649525,-14410898
25000000,2009,2336172,Me and Orson Welles,995.9942042,-22663828
25000000,2009,163670000,Up in the Air,3316.277271,138670000
16500000,1995,135000000,Sense and Sensibility,492.6206439,118500000
16000000,1994,247275374,Dumb and Dumber,108.7354856,231275374
18000000,1998,9495408,The Red Violin,0.0,-8504592
13000000,1987,123922370,"Good Morning, Vietnam",0.0,110922370
6000000,1961,43656822,West Side Story,0.0,37656822
22000000,2005,17709155,Joyeux NoÃ«l,500.0399237,-4290845
22000000,2005,22400154,Deuce Bigalow: European Gigolo,506.1042143,400154
22000000,2005,57479076,Derailed,1125.544687,35479076
24000000,2008,42105111,Zack and Miri Make a Porno,288.5321105,18105111
20000000,2002,75597042,The Rookie,545.6487298,55597042
20000000,2002,8586376,Boat Trip,889.8111447,-11413624
20000000,2002,109862682,Return to Never Land,0.0,89862682
20000000,2002,57588485,Drumline,27.29328783,37588485
20000000,2002,5359645,Equilibrium,224.4642116,-14640355
20000000,2002,12398628,Undisputed,375.6944028,-7601372
20000000,2002,33526835,Friday After Next,655.5280132,13526835
14000000,1990,463000000,Pretty Woman,60.51906115,449000000
23000000,2007,29541790,In the Valley of Elah,3567.95479,6541790
12000000,1985,68706993,Witness,7085.793503,56706993
17000000,1997,125586134,I Know What You Did Last Summer,0.0,108586134
13000000,1988,44726644,Young Guns,128.9631437,31726644
24000000,2009,68729358,The Men Who Stare at Goats,4563.020576,44729358
20000000,2003,60427839,21 Grams,578.9112749,40427839
20000000,2003,135680000,The Jungle Book 2,2115.521339,115680000
20000000,2003,1675706,Marci X,417.0156054,-18324294
20000000,2003,132675402,Bringing Down the House,792.5662977,112675402
20000000,2003,17432163,A Guy Thing,224.0056774,-2567837
9000000,1976,25000000,Logan's Run,0.0,16000000
14000000,1991,34793160,White Fang,658.3566282,20793160
10700000,1982,122200000,Poltergeist,0.0,111500000
23000000,2008,150816700,Step Up 2: The Streets,0.0,127816700
12000000,1986,4884663,Invaders from Mars,21.23456121,-7115337
23600000,2009,102391382,Zombieland,193.4422081,78791382
10000000,1980,15795189,The Long Riders,24.91701043,5795189
17000000,1998,30331165,A Night at the Roxbury,0.0,13331165
16500000,1997,67683989,Austin Powers: International Man of Mystery,229.3264521,51183989
18000000,2000,17200925,Center Stage,0.0,-799075
14600000,1993,70906973,Groundhog Day,187.8895874,56306973
15000000,1994,107217396,Ace Ventura: Pet Detective,70.8702484,92217396
15000000,1994,94000000,The Crow,4.612999574,79000000
19000000,2002,32801173,Adaptation.,2581.210066,13801173
22000000,2007,413454,The Death and Life of Bobby Z,2523.109077,-21586546
22000000,2007,147880543,The Game Plan,556.831137,125880543
10500000,1982,792910554,E.T. the Extra-Terrestrial,0.0,782410554
8000000,1973,441306145,The Exorcist,60.45035321,433306145
20000000,2004,72258126,Eternal Sunshine of the Spotless Mind,4453.885788,52258126
20000000,2004,100914445,Kung Fu Hustle,0.0,80914445
20000000,2004,11341016,Connie and Carla,1223.805593,-8658984
20000000,2004,167722310,DodgeBall: A True Underdog Story,1493.6708,147722310
20000000,2004,16605763,Paparazzi,366.6486815,-3394237
20000000,2004,70992898,Anacondas: The Hunt for the Blood Orchid,0.0,50992898
14000000,1992,159157447,Unforgiven,1138.843683,145157447
11000000,1984,153083102,Gremlins,0.0,142083102
23000000,2009,5837674,Bodyguards and Assassins,0.0,-17162326
23000000,2009,9366227,Cheri,1370.53003,-13633773
21000000,2006,26193068,Black Book,0.0,5193068
21000000,2006,480314,DOA: Dead or Alive,221.7901425,-20519686
12300000,1988,84460846,The Land Before Time,0.0,72160846
10000000,1981,2154696,Heartbeeps,0.0,-7845304
10000000,1981,85300000,Stripes,0.0,75300000
17000000,1999,65535067,Deuce Bigalow: Male Gigolo,0.933879523,48535067
16000000,1997,1686429,Steel,0.0,-14313571
18000000,2001,141774679,Legally Blonde,210.6083018,123774679
13000000,1990,35763605,Child's Play 2,99.98628575,22763605
6000000,1964,102272727,Mary Poppins,0.0,96272727
19000000,2003,39267515,Dumb and Dumberer: When Harry Met Lloyd,5.00115902,20267515
20000000,2005,10442808,Alone in the Dark,884.5052414,-9557192
20000000,2005,67192859,Boogeyman,0.0,47192859
20000000,2005,12482775,The Weather Man,3071.534976,-7517225
14000000,1993,154864401,Cool Runnings,0.0,140864401
14000000,1993,27515786,Poetic Justice,0.0,13515786
9250000,1979,29174648,The Rose,14.17964771,19924648
17700000,2001,30987695,Joe Dirt,447.299918,13287695
21000000,2007,41170784,Freedom Writers,840.1100092,20170784
21000000,2007,54926886,We Own the Night,2114.581133,33926886
17000000,2000,213525736,"Crouching Tiger, Hidden Dragon",565.3677293,196525736
7200000,1971,116019547,Diamonds Are Forever,2136.920663,108819547
18000000,2002,676698,Salton Sea,2114.968336,-17323302
15000000,1996,24769466,The Craft,22.37099225,9769466
15000000,1996,76382,Silent Trigger,4.416701719,-14923618
19000000,2004,69631118,Without a Paddle,602.7439979,50631118
19000000,2004,70067909,A Cinderella Story,169.4760943,51067909
22000000,2009,35424826,The Informant!,4480.408524,13424826
5800000,1964,6800000,The Train,331.9481677,1000000
5000000,1959,12200000,Solomon and Sheba,82.1412018,7200000
20000000,2006,13391174,One Night with the King,108.8792216,-6608826
20000000,2006,22165608,The Marine,784.9992214,2165608
20000000,2006,17807569,School for Scoundrels,1159.833151,-2192431
20000000,2006,39143839,The Grudge 2,957.322369,19143839
20000000,2006,37597471,The Covenant,0.0,17597471
20000000,2006,33889159,She's the Man,75.9235114,13889159
20000000,2006,21170563,ATL,0.0,1170563
20000000,2006,48548426,Date Movie,329.0824251,28548426
20000000,2006,41237648,Man of the Year,4224.489932,21237648
14000000,1994,18090181,New Nightmare,423.5377535,4090181
21000000,2008,17600000,Swing Vote,3059.493855,-3400000
4000000,1952,36000000,The Greatest Show on Earth,55.64873229,32000000
10000000,1983,20766616,The Dead Zone,296.8311626,10766616
10000000,1983,29450919,Twilight Zone: The Movie,0.0,19450919
10000000,1983,33697647,The Outsiders,0.0,23697647
4500000,1956,10400000,Moby Dick,289.4348894,5900000
16000000,1999,53478166,10 Things I Hate About You,0.0,37478166
16000000,1999,18564088,The Thirteenth Floor,39.38981315,2564088
18000000,2003,101564935,Just Married,482.3465049,83564935
18000000,2003,62646763,Honey,391.3932857,44646763
4100000,1953,36000000,The Robe,0.0,31900000
15000000,1997,64256513,Wag the Dog,2176.262445,49256513
15000000,1997,44862187,Cop Land,2743.788351,29862187
15000000,1997,43101594,Boogie Nights,343.8652834,28101594
19000000,2005,108047131,The Amityville Horror,56.05403805,89047131
19000000,2005,144216468,The Exorcism of Emily Rose,768.6708294,125216468
14500000,1996,147298761,Romeo + Juliet,57.3247938,132798761
18339750,2004,92180910,Downfall,0.0,73841160
20000000,2007,4001121,I'm Not There.,1920.382116,-15998879
20000000,2007,10337477,Code Name: The Cleaner,1173.131555,-9662523
20000000,2007,121463226,Superbad,0.0,101463226
20000000,2007,22222308,Reign Over Me,1857.119025,2222308
20000000,2007,117760134,Disturbia,2404.63413,97760134
20000000,2007,84146832,Premonition,2004.386649,64146832
20000000,2007,16974459,Death Sentence,1649.066823,-3025541
20000000,2007,86865564,Epic Movie,140.3356842,66865564
20000000,2007,73276047,The Kite Runner,0.0,53276047
6500000,1969,81974493,On Her Majesty's Secret Service,0.0,75474493
14000000,1995,19800000,Vampire in Brooklyn,1985.948334,5800000
14000000,1995,2474000,Jefferson in Paris,510.0782413,-11526000
20500000,2008,10089373,Punisher: War Zone,561.5919899,-10410627
10000000,1984,8801940,Body Double,5.448763257,-1198060
16000000,2000,15427192,Drowning Mona,1425.204747,-572808
16000000,2000,119754278,Road Trip,28.20843528,103754278
16000000,2000,68411275,PokÃ©mon: Spell of the Unknown,0.0,52411275
16000000,2000,20627372,Boys and Girls,392.8761703,4627372
18000000,2004,65070412,Barbershop 2:  Back in Business,827.9070175,47070412
18000000,2004,16702864,Catch That Kid,293.7415423,-1297136
11500000,1989,57469467,Pet Sematary,0.0,45969467
15000000,1998,46189568,The Big Lebowski,828.3207757,31189568
15000000,1998,40283321,The Faculty,44.43194408,25283321
15000000,1998,17507368,Disturbing Behavior,0.0,2507368
15000000,1998,46905889,The Object of My Affection,27.2271319,31905889
15000000,1998,10443316,Home Fries,1549.793718,-4556684
19000000,2006,83258226,Pan's Labyrinth,48.5504299,64258226
19000000,2006,68673228,Letters from Iwo Jima,649.4356049,49673228
12500000,1992,10725228,Glengarry Glen Ross,1563.421409,-1774772
20000000,2008,27640028,Lakeview Terrace,3795.230674,7640028
20000000,2008,50907234,Doubt,1471.316135,30907234
20000000,2008,64822796,The Bank Job,596.6033184,44822796
20000000,2008,36620508,My Best Friend's Girl,869.4624796,16620508
20000000,2008,149281606,Beverly Hills Chihuahua,2710.78289,129281606
20000000,2008,65569869,Street Kings,3759.225929,45569869
20000000,2008,41627431,Never Back Down,0.0,21627431
20000000,2008,5530764,The Brothers Bloom,1414.516796,-14469236
20000000,2008,7000000,An American Carol,202.212073,-13000000
20000000,2008,20211394,Appaloosa,3417.623363,211394
20000000,2008,54586584,Milk,2300.256383,34586584
14000000,1996,173046663,Scream,203.1386942,159046663
6244087,1969,638641,The Wild Bunch,149.1046914,-5605446
10000000,1985,57500000,Commando,672.8973991,47500000
10000000,1985,25754284,The Last Dragon,0.0,15754284
17000000,2003,1569918,Veronica Guerin,1605.223995,-15430082
17000000,2003,55534455,The Lizzie McGuire Movie,0.0,38534455
17000000,2003,63102666,Jeepers Creepers 2,91.22608062,46102666
7000000,1973,161777836,Live and Let Die,0.0,154777836
17500000,2004,38000000,Hotel Rwanda,414.1674852,20500000
16000000,2001,29381649,Baby Boy,0.0,13381649
16000000,2001,66468332,Not Another Teen Movie,0.0,50468332
13000000,1994,7820688,Serial Mom,86.90675903,-5179312
5500000,1965,141195658,Thunderball,1244.713956,135695658
15000000,1999,2856712,eXistenZ,463.2610557,-12143288
15000000,1999,356296601,American Beauty,963.1619394,341296601
12500000,1993,12281551,True Romance,808.4503219,-218449
20000000,2009,22942221,Armored,2409.575294,2942221
20000000,2009,136267476,17 Again,424.1955399,116267476
20000000,2009,51416464,Daybreakers,2424.809256,31416464
20000000,2009,17436509,Capitalism: A Love Story,485.2568905,-2563491
20000000,2009,34560577,Crank: High Voltage,760.5338176,14560577
20000000,2009,41596251,Orphan,480.4190887,21596251
20000000,2009,5210988,Bandslam,6.124351522,-14789012
20000000,2009,17280326,12 Rounds,28.84144224,-2719674
6500000,1971,12376563,The Andromeda Strain,0.0,5876563
11000000,1989,49797148,Major League,435.956096,38797148
12000000,1992,37170057,Raising Cain,205.4436875,25170057
17000000,2004,16980098,Win a Date with Tad Hamilton!,81.19453998,-19902
17000000,2004,129042871,Mean Girls,163.3986022,112042871
16500000,2003,16942795,House of Sand and Fog,831.9660506,442795
7000000,1974,97572000,The Man with the Golden Gun,582.0804117,90572000
18000000,2006,1831348,Renaissance,520.4550334,-16168652
18000000,2006,261572744,Borat: Cultural Learnings of America for Make Benefit Glorious Nation of Kazakhstan,0.0,243572744
6000000,1969,102308889,Butch Cassidy and the Sundance Kid,261.3423124,96308889
15000000,2000,33771174,Where the Heart Is,1573.238395,18771174
15000000,2000,5217498,The In Crowd,0.0,-9782502
15000000,2000,9902115,Whatever It Takes,0.0,-5097885
15000000,2000,35007180,The Skulls,7.679760601,20007180
19000000,2008,18755936,Sex Drive,0.0,-244064
10500000,1988,14144000,Poltergeist III,315.6260912,3644000
8000000,1979,43000000,Escape from Alcatraz,246.69469,35000000
14000000,1998,72527595,Urban Legend,1.043061604,58527595
11000000,1990,48572000,Tremors,186.807031,37572000
4000000,1956,14400000,Trapeze,190.1122379,10400000
7000000,1975,470654000,Jaws,562.5827776,463654000
17500000,2006,19179969,Beerfest,33.75862617,1679969
18000000,2007,26527510,Mongol: The Rise of Genghis Khan,0.0,8527510
18000000,2007,57096190,The Mist,382.5182768,39096190
13000000,1996,9789900,Faithful,62.32953029,-3210100
15000000,2001,20117339,Mulholland Drive,6.853433598,5117339
15000000,2001,23000,All The Queen's Men,224.4309901,-14977000
15000000,2001,274925095,Spirited Away,0.0,259925095
15000000,2001,12000000,Knockaround Guys,34.66352054,-3000000
14000000,1999,18535191,An Ideal Husband,141.1706151,4535191
11000000,1991,2807854,Return to the Blue Lagoon,0.0,-8192146
11000000,1991,34872033,Freddy's Dead: The Final Nightmare,377.2980728,23872033
17000000,2006,374743,Southland Tales,957.322369,-16625257
17000000,2006,9500000,Running Scared,835.7614011,-7500000
17000000,2006,57103895,Smokin' Aces,302.3397694,40103895
17000000,2006,7314027,American Dreamz,1924.990864,-9685973
16000000,2004,109502303,Sideways,343.7507032,93502303
16000000,2004,14822346,Soul Plane,598.2057725,-1177654
16000000,2004,12,The Cookout,20.83249156,-15999988
18000000,2008,25739015,RockNRolla,421.7916831,7739015
18000000,2008,382174,The Informers,1144.255159,-17617826
18500000,2009,31912793,The Invention of Lying,612.1940963,13412793
11500000,1993,3275585,Romeo Is Bleeding,868.1858447,-8224415
11500000,1993,23237911,The Remains of the Day,1083.789681,11737911
15000000,2002,52970014,Big Fat Liar,276.0273074,37970014
15000000,2002,13060843,25th Hour,370.4425741,-1939157
15000000,2002,9237470,Dark Blue,741.2020064,-5762530
16800000,2006,2281089,Fur: An Imaginary Portrait of Diane Arbus,1512.344452,-14518911
12500000,1996,1227324,The Funeral,355.2164559,-11272676
14000000,2000,38574362,Urban Legends: Final Cut,0.0,24574362
14000000,2000,5108820,Gossip,29.47130473,-8891180
11000000,1992,64088552,My Cousin Vinny,1168.557693,53088552
12716953,1997,18814720,Mr. Nice Guy,59.58385121,6097767
10000000,1989,40485039,Bill & Ted's Excellent Adventure,0.0,30485039
18000000,2009,36133014,Love Happens,2132.732446,18133014
13000000,1998,8026971,Woo,357.6112058,-4973029
13000000,1998,27007143,The Big Hit,367.0907469,14007143
13000000,1998,16757163,54,222.286077,3757163
6000000,1972,245066411,The Godfather,72.19639578,239066411
8000000,1982,21028755,Creepshow,61.26648344,13028755
14000000,2001,10424470,Head Over Heels,267.9568309,-3575530
11000000,1993,30000000,What's Eating Gilbert Grape,110.6646183,19000000
12000000,1996,4939939,Girl 6,31.57598271,-7060061
12000000,1996,41205099,Happy Gilmore,0.0,29205099
13500000,2000,7060876,Quills,3370.498925,-6439124
10000000,1990,16153593,Mo' Better Blues,60.1537316,6153593
16500000,2007,37311672,Becoming Jane,922.1583791,20811672
16500000,2007,13620075,Sydney White,120.2453116,-2879925
13000000,1999,27500000,Dick,491.2477616,14500000
13000000,1999,22863596,Being John Malkovich,1812.633643,9863596
15500000,2005,1237615,Slow Burn,466.1575041,-14262385
15000000,2004,14867514,Raise Your Voice,169.4760943,-132486
15000000,2004,29331068,Confessions of a Teenage Drama Queen,227.1397139,14331068
14000000,2002,6413915,Slackers,91.22133936,-7586085
14000000,2002,25482931,All About the Benjamins,655.5280132,11482931
8200000,1984,80035402,Footloose,32.69257954,71835402
12000000,1997,39673162,Jackie Brown,1510.98565,27673162
17000000,2009,20455276,My Life in Ruins,1258.274658,3455276
17000000,2009,29536299,Brooklyn's Finest,1961.937762,12536299
17000000,2009,14899417,Away We Go,142.2261293,-2100583
16000000,2007,18928871,A Mighty Heart,2129.669015,2928871
16000000,2007,2849142,Things We Lost in the Fire,2488.866577,-13150858
13000000,2000,73180723,"Dude, Whereâs My Car?",421.3497886,60180723
15000000,2005,15785148,Kiss Kiss Bang Bang,2203.725434,785148
15000000,2005,85306374,Match Point,173.8493514,70306374
15000000,2005,51053787,Hoodwinked!,1457.158144,36053787
15000000,2005,47175038,The Wedding Date,454.2508794,32175038
15000000,2005,46770602,Land of the Dead,1216.127666,31770602
15000000,2005,12036149,The Three Burials of Melquiades Estrada,3735.110299,-2963851
5000000,1968,5321508,Once Upon a Time in the West,4.595450421,321508
8000000,1984,69821334,Splash,0.0,61821334
8000000,1984,27187653,A Passage to India,303.1073424,19187653
8000000,1984,90815558,The Karate Kid,90.21760468,82815558
9000000,1988,44196684,Child's Play,0.0,35196684
12800000,2000,40031879,Dancer in the Dark,549.8122434,27231879
11000000,1995,2832826,The Perez Family,379.9530629,-8167174
11000000,1995,39363635,Dead Man Walking,227.4813181,28363635
12000000,1998,12902790,Living Out Loud,1476.796209,902790
12000000,1998,22921898,Rounders,481.1718734,10921898
13500000,2002,29027914,Far from Heaven,591.6741494,15527914
4000000,1961,8200000,The Misfits,2323.597077,4200000
10000000,1992,32101000,The Lawnmower Man,0.0,22101000
10000000,1992,50752337,The Mighty Ducks,102.0934768,40752337
16000000,2008,50007546,The Women,966.3188668,34007546
13000000,2001,16929123,Crazy/Beautiful,695.499288,3929123
13000000,2001,91038276,Save the Last Dance,87.40127794,78038276
15000000,2006,66966987,When a Stranger Calls,36.52545008,51966987
15000000,2006,10903846,Black Snake Moan,3745.331713,-4096154
15000000,2006,21000000,Flicka,119.5124805,6000000
15000000,2006,123384128,The Queen,773.3173331,108384128
15000000,2006,76286096,United 93,0.0,61286096
15000000,2006,49469904,Notes on a Scandal,1699.38202,34469904
15000000,2006,69623713,The Hills Have Eyes,113.7896251,54623713
10500000,1994,123509,There Goes My Baby,0.0,-10376491
8500000,1987,32222567,The Lost Boys,210.3360505,23722567
12000000,1999,36450736,Baby Geniuses,2355.38372,24450736
12000000,1999,21133087,Stir of Echoes,1380.373684,9133087
12000000,1999,21001563,Tea with Mussolini,17.11937196,9001563
16000000,2009,47801389,Hachi: A Dog's Tale,1961.937762,31801389
16000000,2009,31556061,Jennifer's Body,915.638974,15556061
16000000,2009,76514050,The Unborn,1633.96118,60514050
16000000,2009,11301649,Tidal Wave,0.0,-4698351
13000000,2002,97837138,Phone Booth,493.4031458,84837138
13000000,2002,37664855,Halloween: Resurrection,976.2989055,24664855
14200000,2005,674918,Manderlay,1403.169356,-13525082
5500000,1973,15700000,High Plains Drifter,226.7379657,10200000
5500000,1973,159616327,The Sting,626.0861478,154116327
15000000,2007,55184721,Why Did I Get Married?,215.5483785,40184721
15000000,2007,7938872,Funny Games,1092.203118,-7061128
15000000,2007,30226144,The Great Debaters,2779.256204,15226144
15000000,2007,56255142,Into the Wild,292.4531601,41255142
15000000,2007,20380,The Good Night,1441.010781,-14979620
15000000,2007,64238440,28 Weeks Later,890.0010101,49238440
15000000,2007,22730842,U2 3D,0.0,7730842
8000000,1986,52287414,Stand by Me,83.97729621,44287414
14000000,2005,178043761,Brokeback Mountain,824.5191246,164043761
14000000,2005,32645546,Because of Winn-Dixie,575.730842,18645546
12000000,2000,15250000,Brother,65.18560372,3250000
4000000,1963,11744471,The Great Escape,0.0,7744471
10000000,1994,29392418,A Low Down Dirty Shame,321.1491094,19392418
15000000,2008,317000,The Yellow Handkerchief,359.0735915,-14683000
15000000,2008,377910544,Slumdog Millionaire,0.0,362910544
15000000,2008,96408652,Vicky Cristina Barcelona,602.9338087,81408652
15000000,2008,34533783,In Bruges,1974.690676,19533783
15000000,2008,5926410,Transsiberian,231.7521922,-9073590
15000000,2008,42000000,The Hurt Locker,67.16794066,27000000
15000000,2008,3533227,The Midnight Meat Train,116.011082,-11466773
15000000,2008,8762890,The Rocker,254.4401495,-6237110
12500000,2002,23367586,Antwone Fisher,0.0,10867586
3500000,1959,12800000,The Nun's Story,0.0,9300000
6500000,1980,31899000,Dressed to Kill,155.6155129,25399000
12000000,2001,31155435,How High,0.0,19155435
12000000,2001,17292381,Max Keeble's Big Move,0.0,5292381
7000000,1983,1246141,Losin' It,0.0,-5753859
13000000,2004,96060858,The Butterfly Effect,261.8336135,83060858
12600000,2003,28650575,Wrong Turn,140.5299539,16050575
6000000,1978,181813770,Grease,0.0,175813770
15000000,2009,32721635,The Last House on the Left,0.0,17721635
15000000,2009,8459458,Chloe,2724.383539,-6540542
15000000,2009,35097815,Whatever Works,128.2555418,20097815
15000000,2009,16633035,Whip It,307.768937,1633035
15000000,2009,100734718,My Bloody Valentine,149.464171,85734718
15000000,2009,6405245,Post Grad,107.9383482,-8594755
15000000,2009,39421467,Halloween II,22.40145322,24421467
15000000,2009,40105542,All About Steve,2014.700413,25105542
15000000,2009,5024782,Solitary Man,1773.167866,-9975218
8000000,1988,553171,Akira,0.0,-7446829
14000000,2007,19777647,The Diving Bell and the Butterfly,4.776387222,5777647
12806000,2004,38535221,The Sea Inside,0.218965964,25729221
11000000,1999,235483004,American Pie,0.0,224483004
12000000,2002,56298474,Frida,246.6455069,44298474
12000000,2002,52223306,One Hour Photo,4014.476504,40223306
12000000,2002,61141030,Crossroads,27.29328783,49141030
12000000,2002,75781642,Barbershop,655.5280132,63781642
8000000,1989,22168359,A Nightmare on Elm Street 5: The Dream Child,342.8803093,14168359
11000000,2000,59827328,Next Friday,562.9312104,48827328
12000000,2003,23,In the Cut,1358.265594,-11999977
12000000,2003,4922166,From Justin to Kelly,0.0,-7077834
10000000,1997,13835130,The Spanish Prisoner,10.24831217,3835130
10000000,1997,225933435,Good Will Hunting,3119.508053,215933435
13000000,2006,2636637,Find Me Guilty,1944.070896,-10363363
13000000,2006,4857367,"Paris, je t'aime",3748.773044,-8142633
13000000,2006,1151330,Infamous,1474.787899,-11848670
13000000,2006,11130889,The Astronaut Farmer,1159.833151,-1869111
6000000,1980,39846344,Caddyshack,0.0,33846344
10500000,1999,75902208,Cruel Intentions,246.5457375,65402208
12899867,2006,85582407,Volver,670.3744345,72682540
9000000,1994,4350774,PCU,0.0,-4649226
14000000,2009,22852638,A Perfect Getaway,725.3819505,8852638
3000000,1957,33300000,The Bridge on the River Kwai,0.0,30300000
3800000,1965,14873,Major Dundee,229.3183386,-3785127
11000000,2001,23430766,Tomcats,0.0,12430766
11000000,2001,13110448,Frailty,1982.991501,2110448
11000000,2001,23978402,Corky Romano,49.99472854,12978402
11000000,2001,16951798,Jason X,84.98831503,5951798
12000000,2004,19271312,2046,848.6060605,7271312
12000000,2004,31179516,Johnson Family Vacation,378.6225397,19179516
12000000,2004,9584131,District B13,0.0,-2415869
12000000,2004,24829644,Seed of Chucky,329.8184054,12829644
3900000,1966,28350000,A Man for All Seasons,31.27181262,24450000
10000000,1998,6451628,Gods and Monsters,17.98383968,-3548372
10000000,1998,45779,"An Alan Smithee Film: Burn, Hollywood, Burn",2755.103947,-9954221
10000000,1998,25605015,Can't Hardly Wait,222.286077,15605015
13000000,2007,75511123,Stomp the Yard,0.0,62511123
6000000,1981,50244700,Escape from New York,18.96477744,44244700
2540800,1952,7200000,Singin' in the Rain,20.90550975,4659200
5000000,1975,41833347,The Return of the Pink Panther,1075.939862,36833347
8000000,1991,2275557,Showdown in Little Tokyo,0.0,-5724443
3000000,1958,17570324,Cat on a Hot Tin Roof,0.0,14570324
7500000,1989,145793296,Driving Miss Daisy,609.5066763,138293296
11000000,2002,41227069,A Walk to Remember,15.71201984,30227069
4638783,1973,11000000,Pat Garrett & Billy the Kid,0.0,6361217
10000000,1999,3193102,The Limey,0.0,-6806898
10000000,1999,10571408,Drop Dead Gorgeous,491.2477616,571408
10000000,1999,12827813,Office Space,80.60476508,2827813
10000000,1999,103166989,She's All That,68.74106662,93166989
10000000,1999,30652890,Dogma,1364.250836,20652890
6400000,1984,78371200,The Terminator,213.7115073,71971200
8000000,1992,6739141,Fortress,409.7934555,-1260859
9000000,1996,41590886,Set It Off,55.68814051,32590886
12000000,2006,42931041,Crank,508.2753518,30931041
12000000,2006,20138836,The Namesake,33.74607014,8138836
12000000,2006,6754898,Running with Scissors,1005.600362,-5245102
12000000,2006,23006849,Aquamarine,0.0,11006849
12000000,2006,38368909,Employee of the Month,188.0383572,26368909
12000000,2006,5542025,For Your Consideration,556.5696092,-6457975
12000000,2006,114194847,Step Up,0.0,102194847
4000000,1969,6000000,Topaz,0.0,2000000
10000000,2000,83557872,Snatch,2386.454351,73557872
10000000,2000,5164404,The House of Mirth,1000.14519,-4835596
10000000,2000,1631839,Gun Shy,2339.479881,-8368161
7000000,1988,8373585,The Last Temptation of Christ,332.4840411,1373585
7000000,1988,20256975,Action Jackson,302.5915129,13256975
7000000,1988,72500000,A Nightmare on Elm Street 4: The Dream Master,179.1658373,65500000
13000000,2009,754249,Enter the Void,0.0,-12245751
13000000,2009,10652035,I Love You Phillip Morris,4688.48896,-2347965
5500000,1980,4865000,Galaxina,0.0,-635000
12500000,2008,20416563,The Boy in the Striped Pyjamas,12.6242129,7916563
3200000,1962,8000000,The Man Who Shot Liberty Valance,165.6315323,4800000
5952000,1983,2120439,Videodrome,0.0,-3831561
2300000,1951,11000000,Show Boat,56.80808088,8700000
3000000,1960,10400000,Elmer Gantry,290.2778071,7400000
3000000,1960,25000000,The Apartment,136.0583241,22000000
12000000,2007,11293663,Lars and the Real Girl,246.3558723,-706337
12000000,2007,80573774,Hot Fuzz,41.46702829,68573774
10000000,2001,173921954,AmÃ©lie,0.0,163921954
10000000,2001,44460850,Recess: School's Out,0.0,34460850
10000000,2001,59217789,Jeepers Creepers,0.0,49217789
2883848,1959,25000000,Some Like It Hot,82.1412018,22116152
5500000,1981,58972904,Chariots of Fire,0.0,53472904
5000000,1978,7230000,Force 10 from Navarone,2478.790051,2230000
12500000,2009,27206120,Sorority Row,192.8459541,14706120
3500000,1966,12000000,Harper,166.607464,8500000
8000000,1994,213928762,Pulp Fiction,417.28691,205928762
9000000,1998,17096053,Rushmore,317.3215771,8096053
6500000,1987,54215416,La Bamba,0.0,47715416
3000000,1961,10000000,Judgment at Nuremberg,303.4850747,7000000
12000000,2008,43493123,Harold & Kumar Escape from Guantanamo Bay,173.5070216,31493123
12000000,2008,40855419,Quarantine,131.3561094,28855419
12000000,2008,3148182,Two Lovers,2139.689115,-8851818
12000000,2008,56309766,The Eye,840.9447155,44309766
10000000,2002,598645,Swept Away,624.6852887,-9401355
3500000,1967,13007551,In Cold Blood,33.25213722,9507551
8000000,1995,529766,Things to Do in Denver When You're Dead,2328.501903,-7470234
9000000,1999,34573780,The Best Man,49.73944733,25573780
11000000,2006,88489643,The Host,514.5790675,77489643
11000000,2006,72778712,Jackass Number Two,327.6315274,61778712
12000000,2009,10652498,City of Life and Death,0.0,-1347502
12000000,2009,1644755,Ondine,1175.416153,-10355245
2900000,1961,5000000,Pocketful of Miracles,0.0,2100000
10000000,2003,4069090,The Visual Bible: The Gospel of John,533.0391898,-5930910
6000000,1986,138530565,Platoon,0.0,132530565
5000000,1980,26010864,The Elephant Man,0.0,21010864
3716946,1970,5000000,The Ballad of Cable Hogue,21.74352555,1283054
3600000,1969,44785053,Midnight Cowboy,0.0,41185053
9000000,2000,39723096,Memento,773.3251709,30723096
6500000,1989,37295445,Do the Right Thing,0.0,30795445
11000000,2007,13196245,I Think I Love My Wife,1101.306005,2196245
10000000,2004,183474602,The Grudge,730.3806661,173474602
10284523,2005,11588205,Shopgirl,882.8255002,1303682
5000000,1981,42365581,Time Bandits,2007.188871,37365581
5000000,1981,19905359,Nighthawks,378.8717519,14905359
8000000,1997,589304,Prefontaine,0.0,-7410696
7500000,1995,32392047,Rumble in the Bronx,0.0,24892047
11000000,2008,38105395,The Secret Life of Bees,1133.462041,27105395
11000000,2008,53191886,Welcome to the Sticks,0.0,42191886
10000000,2005,17297244,The Matador,3580.585694,7297244
10000000,2005,91196419,White Noise,1073.803667,81196419
7000000,1993,116700000,The Piano,117.1243793,109700000
10800000,2008,113857533,Saw V,606.2553439,103057533
8500000,2000,19125401,The Way of the Gun,368.0556709,10625401
8000000,1998,17460020,Half Baked,0.0,9460020
6900000,1993,7993039,Dazed and Confused,0.0,1093039
9000000,2002,4777465,Igby Goes Down,3390.337214,-4222535
6500000,1991,57504069,Boyz n the Hood,0.0,51004069
11000000,2009,68233629,Saw VI,739.1992999,57233629
10000000,2006,7177143,Rescue Dawn,817.9407286,-2822857
10000000,2006,163876815,Saw III,213.6739239,153876815
10200000,2007,35619521,Hostel: Part II,233.4766585,25419521
9600000,2005,4386236,The Lost City,284.8686162,-5213764
5000000,1983,12232628,Lone Wolf McQuade,67.57896281,7232628
3200000,1968,33395426,Rosemary's Baby,0.0,30195426
8000000,1999,1997807,Limbo,261.4779479,-6002193
8000000,1999,22593409,Drive Me Crazy,0.0,14593409
3000000,1966,13000000,Torn Curtain,1774.858391,10000000
10000000,2007,33000000,"Run, Fatboy, Run",1356.646189,23000000
10000000,2007,17500000,In the Land of Women,1241.435522,7500000
10000000,2007,21786738,My Blueberry Nights,3853.244939,11786738
10000000,2007,139352633,Saw IV,431.6201928,129352633
10000000,2007,20342161,Reno 911!: Miami,1187.375675,10342161
4500000,1980,58853106,The Blue Lagoon,92.16881834,54353106
7000000,1995,25405445,Desperado,0.0,18405445
2686000,1963,6600000,Donovan's Reef,159.269279,3914000
8500000,2002,34411240,Swimfan,155.9838341,25911240
3500000,1972,12600000,Frenzy,0.0,9100000
8000000,2000,8279017,Shadow of the Vampire,1315.668789,279017
9000000,2004,23936908,Harold & Kumar Go to White Castle,58.02112406,14936908
4000000,1977,38251425,Annie Hall,221.262872,34251425
7000000,1996,560069,Bottle Rocket,0.0,-6439931
7000000,1996,14702438,Flirting with Disaster,265.5314711,7702438
6000000,1991,869325,Beastmaster 2: Through the Portal of Time,0.0,-5130675
2000000,1954,271841,Seven Samurai,0.0,-1728159
9000000,2005,1046166,Undiscovered,2940.580561,-7953834
3800000,1976,23689877,Network,123.9075996,19889877
10000000,2009,295750,World's Greatest Dad,4535.775271,-9704250
10000000,2009,47536959,Precious,115.1275886,37536959
10000000,2009,7022728,The Joneses,1701.56151,-2977272
10000000,2009,42333295,The Fourth Kind,665.4989922,32333295
10000000,2009,9069,Janky Promoters,1103.042042,-9990931
1800000,1951,8000000,A Streetcar Named Desire,3050.483332,6200000
4500000,1982,27092880,Fast Times at Ridgemont High,0.0,22592880
5000000,1986,328203506,Crocodile Dundee,0.0,323203506
8500000,2004,5001655,Club Dread,27.89432363,-3498345
8000000,2002,16856124,The Good Girl,159.9811736,8856124
8000000,2002,27362712,Brown Sugar,166.2420735,19362712
9000000,2006,21510851,Black Christmas,67.94677869,12510851
9000000,2006,27105095,Stay Alive,331.1734682,18105095
2500000,1963,10000000,Hud,128.6438124,7500000
6000000,1993,3283371,Only the Strong,62.32248635,-2716629
5000000,1987,44793222,A Nightmare on Elm Street 3: Dream Warriors,74.16043784,39793222
8000000,2003,60378584,Monster,649.0320467,52378584
8000000,2003,1477676,The Triplets of Belleville,0.0,-6522324
8000000,2003,3432342,The Barbarian Invasions,0.0,-4567658
8000000,2003,41400000,Whale Rider,0.0,33400000
9000000,2007,2955039,Gracie,0.0,-6044961
9000000,2007,24538513,Sicko,224.1156824,15538513
9000000,2007,46,Death at a Funeral,165.8188842,-8999954
8700000,2006,7659918,A Scanner Darkly,3768.259685,-1040082
3000000,1970,18999718,Beneath the Planet of the Apes,34.89301579,15999718
9500000,2009,17164377,Adventureland,810.232579,7664377
2500000,1964,124881062,Goldfinger,672.2906434,122381062
4500000,1984,146198896,Police Academy,0.0,141698896
7000000,1999,14011454,In Too Deep,49.73944733,7011454
7000000,1999,7292175,Outside Providence,602.3015065,292175
6000000,1994,254700832,Four Weddings and a Funeral,176.1609106,248700832
7800000,2003,22441323,Swimming Pool,392.6374833,14641323
5000000,1988,17768757,Halloween 4: The Return of Michael Myers,177.353511,12768757
4700000,1986,8025872,The Texas Chainsaw Massacre 2,0.0,3325872
9000000,2008,32973937,Nick and Norah's Infinite Playlist,464.7495523,23973937
3000000,1971,4000000,Willy Wonka & the Chocolate Factory,0.0,1000000
7500000,2002,4245870,Men with Brooms,230.9974937,-3254130
4000000,1981,125728258,Porky's,0.0,121728258
7000000,2000,34266564,American Psycho,1315.668789,27266564
6000000,1995,12000000,Tales from the Hood,100.2604003,6000000
6000000,1995,23341568,The Usual Suspects,0.0,17341568
6000000,1995,2122561,Mallrats,0.0,-3877439
5000000,1989,14000000,Friday the 13th Part VIII: Jason Takes Manhattan,44.27185584,9000000
5000000,1989,11642254,Halloween 5: The Revenge of Michael Myers,213.9554483,6642254
8000000,2005,852872,Down in the Valley,928.2754622,-7147128
8000000,2005,23563727,Hustle & Flow,374.5066372,15563727
8000000,2005,127392239,March of the Penguins,3205.093729,119392239
8000000,2005,2019009,The Rocket: The Legend of Rocket Richard,4.984056232,-5980991
4000000,1982,36690067,Friday the 13th Part III,0.0,32690067
7000000,2001,10229331,The Wash,0.0,3229331
7000000,2001,4720371,The Other Side of Heaven,0.0,-2279629
4200000,1984,38376497,Red Dawn,90.21760468,34176497
3400000,1977,31063038,High Anxiety,0.0,27663038
8500000,2008,8936663,Ong Bak 2,36.40772549,436663
8000000,2006,426224,Fido,2457.839865,-7573776
8000000,2006,12671300,Bon Cop Bad Cop,0.0,4671300
8000000,2006,18948425,Akeelah and the Bee,2553.913627,10948425
8000000,2006,100523181,Little Miss Sunshine,1185.938652,92523181
8000000,2006,143451,10th & Wolf,183.2125825,-7856549
6500000,1999,28451622,Go,30.08529025,21951622
6500000,1999,4217115,Detroit Rock City,41.02787612,-2282885
7500000,2004,3347647,The Work and the Glory,0.0,-4152353
2500000,1967,3200000,Point Blank,29.96000607,700000
1650000,1953,30500000,From Here to Eternity,202.6046078,28850000
4000000,1983,92921203,Flashdance,2.427178084,88921203
7000000,2002,2062066,Auto Focus,1322.342907,-4937934
8500000,2009,4440055,Bright Star,171.9903713,-4059945
8000000,2007,458232,Brooklyn Rules,892.252179,-7541768
7000000,2003,16829545,House of 1000 Corpses,0.0,9829545
6000000,1998,58000000,Sliding Doors,589.5335667,52000000
2000000,1961,7600000,The Hustler,94.47216786,5600000
3500000,1980,83453539,Airplane!,0.0,79953539
3000000,1975,108981275,One Flew Over the Cuckoo's Nest,0.0,105981275
4000000,1985,14237000,The Return of the Living Dead,0.0,10237000
7000000,2004,29385320,Veer-Zaara,0.0,22385320
7400000,2006,17000000,Kabhi Alvida Naa Kehna,41.42719978,9600000
6000000,1999,6852450,200 Cigarettes,1364.250836,852450
6000000,1999,25059640,The Wood,64.73751988,19059640
6000000,1999,4398989,Simply Irresistible,217.7496264,-1601011
6000000,1999,30471,The Boondock Saints,1346.034109,-5969529
6000000,1999,10409377,The Virgin Suicides,603.2417494,4409377
2000000,1962,9250000,Lolita,152.5013017,7250000
2000000,1962,13129846,To Kill a Mockingbird,301.335956,11129846
8000000,2009,10848783,Extract,797.9324534,2848783
8000000,2009,29010817,New in Town,2776.514073,21010817
8000000,2009,10629321,The Boondock Saints II: All Saints Day,6.032687318,2629321
6500000,2002,12633747,Narc,322.1567189,6133747
7500000,2007,231411584,Juno,210.7313217,223911584
2800000,1974,86273333,Young Frankenstein,14.64536438,83473333
7000000,2005,54600000,"Good Night, and Good Luck.",575.730842,47600000
7000000,2005,49084830,Capote,600.8014933,42084830
6000000,2000,9000000,3 Strikes,0.0,3000000
2000000,1963,78898765,From Russia with Love,296.8381349,76898765
5000000,1994,3049135,Heavenly Creatures,0.0,-1950865
3500000,1982,20659423,The Man from Snowy River,79.88163425,17159423
7500000,2008,19000000,The Wave,0.0,11500000
2500000,1971,12348905,Escape from the Planet of the Apes,108.4678113,9848905
6000000,2001,1270522,Donnie Darko,994.3971215,-4729478
6000000,2001,2025238,Novocaine,1571.11404,-3974762
5000000,1995,15116634,Halloween: The Curse of Michael Myers,205.7678718,10116634
6500000,2004,1548955,A Home at the End of the World,1679.2612,-4951045
6500000,2004,98410061,Crash,1841.931994,91910061
6500000,2004,11850214,Layer Cake,0.0,5350214
7500000,2009,26096852,An Education,963.9035594,18596852
7500000,2009,60722734,(500) Days of Summer,1196.220294,53222734
4000000,1988,3468572,Talk Radio,92.99913672,-531428
4000000,1988,13008928,They Live,48.60719129,9008928
2800000,1976,60922980,The Omen,229.8904919,58122980
5000000,1996,13269963,Lone Star,107.9079366,8269963
2600000,1974,119500000,Blazing Saddles,14.64536438,116900000
6500000,2005,2025032,The Work and the Glory II: American Zion,4.817809831,-4474968
6500000,2005,24793509,Thank You for Smoking,690.8817237,18293509
7300000,2009,10329747,Harry Brown,1232.671641,3029747
7000000,2008,1100000,Roadside Romeo,0.0,-5900000
7000000,2008,8900000,Stargate: The Ark of Truth,0.0,1900000
7000000,2008,6230276,College,0.0,-769724
6000000,2003,18750246,A Mighty Wind,0.0,12750246
6000000,2003,2944752,Shattered Glass,991.5066067,-3055248
5000000,1997,3263585,The Sweet Hereafter,0.0,-1736415
3500000,1985,34000000,Day of the Dead,0.0,30500000
6500000,2006,13368437,Friends with Money,424.7107079,6868437
6500000,2006,22889018,The Wind That Shakes the Barley,199.4539657,16389018
7000000,2009,39462438,Crazy Heart,1340.989622,32462438
7000000,2009,31430334,A Serious Man,0.0,24430334
7000000,2009,1429299,I Hope They Serve Beer in Hell,316.8561373,-5570701
6000000,2004,119114517,Fahrenheit 9/11,2375.196281,113114517
5000000,1998,1980338,Zero Effect,2049.77981,-3019662
3600000,1987,5923044,Evil Dead II,74.9842569,2323044
1800000,1964,9440272,Dr. Strangelove or: How I Learned to Stop Worrying and Love the Bomb,0.0,7640272
6000000,2005,27165581,The Protector,0.0,21165581
2700000,1978,141000000,Animal House,0.0,138300000
3500000,1987,14000000,Creepshow 2,543.1875692,10500000
2090000,1970,40000000,Beyond the Valley of the Dolls,0.0,37910000
4500000,1996,7011317,Bound,38.21426613,2511317
6000000,2006,48027970,The Last King of Scotland,865.6187234,42027970
6000000,2006,57231524,Madea's Family Reunion,0.0,51231524
2700000,1979,37799643,The Black Stallion,951.3312078,35099643
1250000,1953,8500000,Niagara,143.0775757,7250000
5000000,2000,110000000,Billy Elliot,0.0,105000000
5300000,2002,3897799,The Spanish Apartment,273.5118059,-1402201
6500000,2009,1521261,The Messenger,193.4422081,-4978739
6000000,2007,18197398,Daddy Day Camp,875.0681017,12197398
5800000,2006,7000000,Crossover,29.59230105,1200000
5000000,2001,33616692,Y Tu MamÃ¡ TambiÃ©n,33.86733997,28616692
5000000,2001,5476060,Made,176.2547717,476060
6000000,2008,69497,"Surfer, Dude",1543.897256,-5930503
6000000,2008,2899975,The Wackness,859.8291609,-3100025
6000000,2008,44703995,The Wrestler,632.7763061,38703995
6000000,2008,7518876,Dolphins and Whales: Tribes of the Ocean,373.7588614,1518876
2000000,1971,11833696,Bananas,0.0,9833696
5000000,2002,368744044,My Big Fat Greek Wedding,0.0,363744044
5000000,2002,64282312,Jackass: The Movie,0.0,59282312
5000000,2002,38275483,National Lampoonâs Van Wilder,232.2064184,33275483
5000000,2002,82719885,28 Days Later,0.0,77719885
3705538,1992,62548947,The Crying Game,0.0,58843409
3000000,1985,29999213,A Nightmare on Elm Street Part 2: Freddy's Revenge,0.0,26999213
3000000,1985,20966644,A Room with a View,0.0,17966644
4000000,1995,4300000,Four Rooms,192.9274642,300000
1800000,1968,6800000,Hang 'em High,89.91294001,5000000
6000000,2009,6670712,City Island,448.7202978,670712
2000000,1972,18016290,Everything You Always Wanted to Know About Sex *But Were Afraid to Ask,45.17090799,16016290
5000000,2003,2466444,Wonderland,2063.806597,-2533556
5000000,2003,742898,Party Monster,1369.838386,-4257102
1200000,1955,7000000,The Trouble with Harry,0.0,5800000
3000000,1986,19472057,Friday the 13th Part VI: Jason Lives,0.0,16472057
4000000,1996,16491080,Trainspotting,14.2030273,12491080
4500000,2000,7390108,Requiem for a Dream,745.3078467,2890108
2000000,1973,18344729,Sleeper,111.0167735,16344729
5000000,2004,8203235,The Machinist,317.783645,3203235
4800000,2003,79384880,"Good bye, Lenin!",0.0,74584880
3500000,1993,27900000,Menace II Society,0.0,24400000
5600000,2009,18469680,[REC]Â²,39.28278328,12869680
3000000,1988,7282851,Phantasm II,0.0,4282851
2500000,1982,14400000,Halloween III: Season of the Witch,0.0,11900000
1800000,1971,41158757,The French Connection,0.0,39358757
5000000,2006,26888376,Clerks II,53.52453259,21888376
5000000,2006,140666,Opal Dream,0.0,-4859334
3600000,1995,49800000,Leaving Las Vegas,84.83755048,46200000
2600000,1984,32980880,Friday the 13th: The Final Chapter,0.0,30380880
4800000,2005,80578934,Hostel,24.99297087,75778934
2700000,1986,3500000,The Wraith,0.0,800000
2000000,1976,7900000,Family Plot,0.0,5900000
5000000,2007,782102,Redacted,0.0,-4217898
3500000,1995,28215918,Friday,114.0917512,24715918
3000000,1990,15369573,Spaced Invaders,0.0,12369573
2800000,1988,19170001,Friday the 13th Part VII: The New Blood,0.0,16370001
4361898,2003,3031801,Mambo Italiano,0.0,-1330097
5000000,2008,16174377,Sunshine Cleaning,511.6598984,11174377
5000000,2008,4040588,Bottle Shock,1768.320498,-959412
5000000,2008,1296184,"War, Inc.",1078.068987,-3703816
3500000,1996,9482579,She's the One,666.1250588,5982579
3800000,1999,28200000,East Is East,0.0,24400000
1700000,1972,9700000,Conquest of the Planet of the Apes,77.68633533,8000000
4000000,2001,44909486,Monster's Ball,953.8037729,40909486
5000000,2009,9760104,Moon,2044.065619,4760104
5000000,2009,17872796,Soul Kitchen,9.940128345,12872796
3500000,1997,257850122,The Full Monty,0.0,254350122
1700000,1973,8844595,Battle for the Planet of the Apes,102.5446677,7144595
4000000,2002,146402,Mondays in the Sun,0.0,-3853598
4000000,2002,35564473,Bowling for Columbine,11.35432686,31564473
4000000,2002,9304609,Secretary,23.52821623,5304609
1455000,1968,2620000,Shalako,2263.965979,1165000
4200000,2004,32000000,Night Watch,0.0,27800000
3000000,1993,15938065,Jason Goes to Hell: The Final Friday,70.12633526,12938065
3000000,1993,1200000,Excessive Force,173.6405996,-1800000
1000000,1956,9000000,Love Me Tender,0.0,8000000
4000000,2003,119723856,Lost in Translation,302.672814,115723856
4000000,2004,30039392,Shaun of the Dead,0.0,26039392
910000,1954,9600000,On the Waterfront,52.90231427,8690000
2000000,1981,24600832,Mad Max 2: The Road Warrior,295.1792139,22600832
1600000,1974,4420000,The Conversation,150.6962484,2820000
4000000,2005,152925093,Saw II,0.0,148925093
4000000,2005,866999,Mirrormask,0.0,-3133001
4500000,2009,744816,Life During Wartime,104.3382388,-3755184
2200000,1985,21930418,Friday the 13th: A New Beginning,0.0,19730418
3000000,1996,4109095,Kama Sutra - A Tale of Love,0.0,1109095
4000000,2006,13401952,The History Boys,0.0,9401952
4000000,2006,4630045,Let's Go to Prison,188.0383572,630045
4000000,2006,31584901,Scoop,1223.144674,27584901
2962051,1996,3011195,Basquiat,719.9922264,49144
3500159,2002,76578641,Bend It Like Beckham,0.0,73078482
1200000,1966,6000000,"The Good, the Bad and the Ugly",66.68254161,4800000
3000000,1997,23144499,Air Bud,0.0,20144499
3000000,1997,302204,Shooting Fish,0.0,-2697796
4000000,2007,2426851,You Kill Me,1302.496999,-1573149
2600000,1993,2850263,Airborne,0.0,250263
3000000,1998,2807390,Happiness,26.11828682,-192610
4000000,2008,530048,Winter in Wartime,0.0,-3469952
2000000,1985,390659,Subway,0.0,-1609341
3300000,2002,30641770,City of God,0.0,27341770
3000000,1999,3076820,Jawbreaker,124.6340253,76820
2900000,1998,5596708,Central Station,0.0,2696708
730000,1952,8000000,High Noon,0.000185036,7270000
1000000,1963,37600000,Tom Jones,0.0,36600000
3500000,2006,113783,Winter Passing,1407.639937,-3386217
950000,1962,59600000,Dr. No,0.0,58650000
3000000,2001,18492362,Super Troopers,0.0,15492362
3800000,2009,111731,Saint John of Las Vegas,434.2828774,-3688269
2500000,1995,5535405,Before Sunrise,615.5926104,3035405
1800000,1984,25504513,A Nightmare on Elm Street,0.0,23704513
3000000,2002,19184015,Martin Lawrence Live: Runteldat,697.4921266,16184015
3000000,2003,14980005,Oldboy,0.0,11980005
2400000,1996,5731103,Get on the Bus,363.456037,3331103
3500000,2009,44462,Defendor,193.4422081,-3455538
3000000,2004,6804016,Woman Thou Art Loosed,58.65693947,3804016
1300000,1976,28262574,Taxi Driver,10.35349541,26962574
806948,1960,32000000,Psycho,0.0,31193052
3000000,2005,18637690,Waiting...,382.5577433,15637690
3000000,2005,11718595,Dave Chappelle's Block Party,213.0147606,8718595
3000000,2005,9879971,Tsotsi,0.0,6879971
2000000,1993,54207,Return of the Living Dead 3,0.0,-1945793
950000,1968,814666,Charly,0.0,-135334
1500000,1984,2300000,Repo Man,0.0,800000
2700000,2004,15992615,Before Sunset,795.1479519,13292615
3000000,2008,3830137,Choke,550.3041932,830137
2600000,2004,3166000,Riding Giants,0.0,566000
3000000,2009,2357852,Fish Tank,0.0,-642148
2500000,2004,26781723,Garden State,2467.435665,24281723
1250000,1981,21722776,Friday the 13th Part 2,0.0,20472776
1500000,1988,11806119,Bloodsport,0.0,10306119
2000000,1998,124494,Six-String Samurai,0.0,-1875506
2053648,1999,500000,Beyond the Mat,0.0,-1553648
2600000,2007,553198,Timecrimes,0.0,-2046802
2000000,1999,7,Dreaming of Joseph Lees,0.0,-1999993
2000000,1999,11540607,Boys Don't Cry,13.06636656,9540607
1000000,1976,117235147,Rocky,27.13185581,116235147
2500000,2007,71904,Eye of the Dolphin,0.0,-2428096
1250000,1984,3412497,C.H.U.D.,0.0,2162497
2000000,2000,20908467,Amores perros,0.0,18908467
2380000,2006,8176544,This Is England,0.0,5796544
2500000,2008,107559,Sleep Dealer,288.1131748,-2392441
2000000,2002,2506446,Full Frontal,363.3098699,506446
1300000,1988,354704,Prison,0.0,-945296
1500000,1993,418961,Killing Zoe,0.0,-1081039
2200000,2006,11502151,Rang De Basanti,0.0,9302151
2000000,2003,1672730,"The Book of Mormon Movie, Volume 1: The Journey",0.0,-327270
2000000,2003,4601043,Thirteen,73.67362573,2601043
1000000,1980,21378361,The Fog,212.8242132,20378361
2000000,2004,120620,It's All Gone Pete Tong,0.0,-1879380
1000000,1981,17985893,The Howling,0.0,16985893
1700000,1999,1943649,"Happy, Texas",195.0166512,243649
1500000,1995,7412216,Kids,0.0,5912216
777000,1973,140000000,American Graffiti,0.0,139223000
2000000,2005,653621,Inside Deep Throat,595.7054736,-1346379
2000000,2005,5048693,The Proposition,631.6695688,3048693
2000000,2005,5967038,Harsh Times,293.1539491,3967038
2000000,2006,5179037,Shortbus,0.0,3179037
2000000,2006,622806,Sherrybaby,13.33657543,-1377194
2000000,2006,70000000,The Lives of Others,0.0,68000000
2000000,2007,22179430,Waitress,53.20181901,20179430
2000000,2007,1431623,No End in Sight,217.3836983,-568377
2000000,2007,5364858,Diary of the Dead,0.0,3364858
1530000,1998,7267585,Run Lola Run,0.0,5737585
560000,1964,12299668,A Hard Day's Night,0.0,11739668
1100000,1987,1400000,From a Whisper to a Scream,35.19499506,300000
1500000,1998,2375097,Buffalo '66,518.5981824,875097
2000000,2008,11125849,Waltz with Bashir,0.0,9125849
2000000,2009,33965843,The Secret in Their Eyes,0.0,31965843
1200000,1992,14661007,Reservoir Dogs,89.55555725,13461007
1000000,1987,14564027,Hellraiser,0.0,13564027
600000,1970,34505110,Woodstock,0.0,33905110
1500000,2001,416925,The Believer,0.0,-1083075
1500000,2001,373967,Session 9,16.61149908,-1126033
1350000,1998,3897569,"Lock, Stock and Two Smoking Barrels",0.0,2547569
860000,1985,2451545,My Beautiful Laundrette,0.0,1591545
1500000,2005,11098131,The Squid and the Whale,768.6708294,9598131
1500000,2005,712294,The Ballad of Jack and Rose,454.3861655,-787706
350000,1957,1000000,12 Angry Men,0.0,650000
1500000,2007,173066,My Name Is Bruce,49.52657321,-1326934
1500000,2007,30448000,[REC],0.0,28948000
1500000,2009,32000,Pontypool,0.0,-1468000
1000000,1996,24475416,Sling Blade,0.0,23475416
500000,1973,3000000,Mean Streets,0.0,2500000
1000000,1997,2057193,Two Girls and a Guy,0.0,1057193
1300000,2006,639000,Journey from the Fall,0.0,-661000
1200000,2004,103911669,Saw,1299.143582,102711669
1000000,1999,10037390,Godzilla 2000,0.0,9037390
1000000,2000,623791,Fiza,0.0,-376209
1000000,2000,1744858,The Broken Hearts Club: A Romantic Comedy,0.0,744858
500000,1977,17000000,Kingdom of the Spiders,0.0,16500000
800000,1993,1001437,Ruby in Paradise,0.0,201437
1000000,2001,852206,Brigham City,34.24597568,-147794
1000000,2001,10013424,Kissing Jessica Stein,0.0,9013424
1000000,2002,464000,Blue Car,228.8826833,-536000
1000000,2005,13350369,Transamerica,104.4633815,12350369
1000000,2005,10047674,Cry_Wolf,0.0,9047674
210000,1953,5000000,"The Beast from 20,000 Fathoms",0.0,4790000
400000,1975,5028948,Monty Python and the Holy Grail,0.0,4628948
1000000,2006,7202,Special,158.2316345,-992798
1000000,2006,10018,Alone With Her,0.0,-989982
1000000,2006,1678874,Who Killed the Electric Car?,7265.071495,678874
1000000,2006,46243000,An Inconvenient Truth,372.3565615,45243000
700000,1994,7830611,Hoop Dreams,0.0,7130611
950000,2005,7022209,Hard Candy,222.5649622,6072209
1000000,2007,274661,Taxi to the Dark Side,0.0,-725339
850000,2003,819939,Latter Days,8.439786491,-30061
900000,2005,381420,The Quiet,43.76665055,-518580
800000,2002,2816116,Raising Victor Vargas,0.0,2016116
400000,1979,100000000,Mad Max,0.0,99600000
800000,2003,62852,The Mudge Boy,0.0,-737148
700000,1999,10508,Naturally Native,610.0746622,-689492
852510,2007,1185783,"4 Months, 3 Weeks and 2 Days",0.0,333273
700000,2001,1667192,L.I.E.,0.0,967192
300000,1975,8000000,Death Race 2000,0.0,7700000
600000,1999,4000000,Human Traffic,0.0,3400000
350000,1981,29400000,The Evil Dead,0.0,29050000
800000,2009,1984662,Dead Snow,0.0,1184662
700000,2006,4911725,Half Nelson,244.8687773,4211725
200000,1964,14500000,A Fistful of Dollars,0.0,14300000
300000,1978,70000000,Halloween,0.0,69700000
500000,2002,150277,May,222.0853767,-349723
500000,2003,8679814,The Station Agent,0.0,8179814
500000,2004,603943,Mean Creek,610.5954745,103943
500000,2008,33456317,Fireproof,0.0,32956317
450000,2006,973525,Conversations with Other Women,987.088027,523525
400000,2004,46118097,Napoleon Dynamite,0.0,45718097
150000,1971,15200000,Sweet Sweetback's Baadasssss Song,0.0,15050000
312000,1999,1281176,Tumbleweeds,0.0,969176
300000,1998,40542,"First Love, Last Rites",3.641209001,-259458
114000,1968,30000000,Night of the Living Dead,0.0,29886000
300000,2001,2074000,Ayurveda: Art of Being,0.0,1774000
220000,1992,2040920,El Mariachi,0.0,1820920
300000,2003,7808524,Tupac: Resurrection,44.74714209,7508524
250000,1997,501818,Cube,0.0,251818
250000,1997,12021272,Chasing Amy,3.904364513,11771272
300000,2005,1750211,Murderball,0.0,1450211
100000,1969,27000000,The Stewardesses,0.0,26900000
250000,2001,4186931,Lovely & Amazing,112.8994104,3936931
200000,1996,4505922,Swingers,0.0,4305922
160000,1989,6706368,Roger & Me,0.0,6546368
180000,1997,900000,Children of Heaven,0.0,720000
85000,1974,30859000,The Texas Chain Saw Massacre,0.0,30774000
230000,2008,2260712,Bronson,16.01024367,2030712
150000,2002,2891288,Tadpole,0.0,2741288
160000,2007,20710513,Once,0.0,20550513
130000,2004,54667954,Open Water,0.0,54537954
100000,2006,10178331,Facing the Giants,0.0,10078331
60000,1998,3221152,Pi,0.0,3161152
60000,1999,248000000,The Blair Witch Project,0.0,247940000
65000,2004,28575078,Super Size Me,0.0,28510078
27000,1994,3151130,Clerks,0.0,3124130
12000,1972,6000000,Pink Flamingos,0.0,5988000
31192,2009,10000,Down Terrace,0.0,-21192
20000,1997,99000,Cure,0.0,79000
10000,1977,7000000,Eraserhead,0.0,6990000
15000,2007,193355800,Paranormal Activity,0.0,193340800
7000,2004,424760,Primer,0.0,417760
250,1998,203,I Married a Strange Person!,0.0,-47
218,2003,1162014,Tarnation,0.0,1161796
30,2000,103,Rugrats in Paris: The Movie,677.0799046,73
28,2001,14,The 51st State,2121.593505,-14
25,1999,13,Angela's Ashes,447.0777621,-12
11,1978,11,F.I.S.T.,404.1667478,0
8,1995,16,The Prophecy,364.409397,8
7,1992,5,Split Second,349.926304,-2
7,2009,7,Bran Nue Dae,1619.208645,0
